# 二简词
be	表示
bq	并且
bt	不同
bx	不行
by	不要
cc	从此
cg	错过
cm	聪明
cq	采取
cx	操心
dn	电脑
dx	大小
ec	上次
ey	使用
fc	服从
fg	中国
fh	符合
gc	刚才
gk	赶快
hc	花草
hk	很快
kc	快餐
kk	可靠
ln	两年
mt	明天
mx	梦想
my	满意
np	哪怕
pe	平时
pq	脾气
pt	平台
px	平安
py	拼音
rc	如此
rg	人工
rh	如何
rm	人们
rq	日期
rs	热搜
rx	热线
sc	三次
sg	搜狗
sm	司马
sq	索取
sx	思想
tn	太难
tx	同学
tq	天气
wc	为此
wq	完全
yc	因此
yj	以及
ym	郁闷
yn	一年
yq	要求
yr	有人
yx	有些
yx	以下
yx	因而
zc	字词
zf	做饭
zg	字根
zm	在吗
zq	组长
zt	昨天
zx	仔细
# 630
ba	不能
baa	步骤
bai	不了
bao	宝贝
bau	不好
bav	办法
bi	不但
bia	不仅
bii	别人
bio	不错
biu	不少
biv	不会
bo	不是
boa	不让
boi	便是
boo	表情
bou	不断
bov	毕竟
bu	不用
bua	不然
bui	别的
buo	部分
buu	必须
buv	不管
bv	不过
bva	不到
bvi	不想
bvo	本来
bvu	变成
bvv	白天
ca	参加
caa	曾经
cai	错了
cao	才能
cau	刺激
cav	脆弱
ci	操作
cia	从中
cii	此人
cio	促销
ciu	从小
civ	从此
co	才是
coa	测试
coi	此时
coo	匆忙
cou	此前
cov	此刻
cu	采用
cua	此外
cui	摧毁
cuo	参考
cuu	厕所
cuv	侧重
cv	存在
cva	参与
cvi	从事
cvo	从来
cvu	才有
cvv	从未
da	到了
daa	大约
dai	肚子
dao	都能
dau	打架
dav	登录
di	多少
dia	当中
dii	多个
dio	短信
diu	动作
div	都会
do	但是
doa	的话
doi	都是
doo	大家
dou	弟弟
dov	地方
du	当然
dua	多么
dui	独自
duo	读者
duu	等待
duv	打算
dv	东西
dva	大概
dvi	底下
dvo	大哥
dvu	都有
dvv	对于
ea	生活
eaa	实验
eai	身子
eao	失败
eau	实力
eav	说法
ei	时候
eia	世界
eii	收获
eio	时光
eiu	数据
eiv	身上
eo	时间
eoa	说话
eoi	数量
eoo	事情
eou	说着
eov	声音
eu	什么
eua	舒服
eui	是的
euo	十分
euu	稍微
euv	上午
ev	手机
eva	收到
evi	剩下
evo	上来
evu	上面
evv	属于
fa	只能
faa	纷纷
fai	房子
fao	否则
fau	只好
fav	发展
fi	这个
fia	这里
fii	专业
fio	非常
fiu	直接
fiv	这些
fo	知道
foa	中心
foi	只是
foo	方案
fou	之前
fov	这次
fu	这么
fua	服务
fui	方向
fuo	这都
fuu	之后
fuv	这种
fv	这样
fva	找到
fvi	只要
fvo	发起
fvu	只有
fvv	发现
ga	更加
gaa	高级
gai	过了
gao	关注
gau	更好
gav	公司
gi	工作
gia	刚刚
gii	赶紧
gio	关键
giu	根据
giv	观点
go	感觉
goa	告诉
goi	更是
goo	国家
gou	跟着
gov	改变
gu	关系
gua	更多
gui	各自
guo	感受
guu	过后
guv	各种
gv	过去
gva	感到
gvi	根本
gvo	过来
gvu	尴尬
gvv	关于
ha	还没
haa	缓缓
hai	好了
hao	还能
hau	还好
hav	喝酒
hi	好像
hia	后果
hii	行业
hio	黄金
hiu	很少
hiv	还会
ho	还是
hoa	好吧
hoi	会是
hoo	回家
hou	呼吸
hov	何况
hu	好的
hua	很多
hui	浑身
huo	或者
huu	还行
huv	合适
hv	还有
hva	回到
hvi	还要
hvo	回来
hvu	后面
hvv	后天
ja	继续
jaa	成绩
jai	除了
jao	绝对
jau	就好
jav	记录
ji	结果
jia	家里
jii	几个
jio	经常
jiu	就像
jiv	就会
jo	就是
joa	建议
joi	及时
joo	决定
jou	成为
jov	解决
ju	觉得
jua	竟然
jui	阶段
juo	进入
juu	进行
juv	就算
jv	今天
jva	计划
jvi	就要
jvo	出来
jvu	就有
jvv	出现
ka	可以
kaa	看书
kai	看出
kao	可能
kau	开始
kav	夸张
ki	考虑
kia	看见
kii	刻苦
kio	块钱
kiu	科技
kiv	快点
ko	可是
koa	开心
koi	空间
koo	肯定
kou	看着
kov	渴望
ku	控制
kua	快乐
kui	空白
kuo	可爱
kuu	靠近
kuv	空气
kv	开车
kva	看到
kvi	快速
kvo	看来
kvu	看成
kvv	款式
la	例如
laa	连续
lai	来了
lao	练习
lau	良好
lav	立即
li	两个
lia	类似
lii	令人
lio	两位
liu	老师
liv	联合
lo	老是
loa	理论
loi	力量
loo	厉害
lou	来着
lov	立刻
lu	了解
lua	联系
lui	来自
luo	老爸
luu	懒得
luv	力气
lv	里面
lva	来到
lvi	留下
lvo	领域
lvu	老板
lvv	离开
ma	妈妈
maa	梦乡
mai	妹子
mao	面对
mau	美女
mav	勉强
mi	每个
mia	默默
mii	某个
mio	没错
miu	摸摸
miv	马上
mo	目前
moa	名叫
moi	明显
moo	慢慢
mou	面前
mov	每次
mu	明白
mua	没用
mui	目的
muo	摸索
muu	矛盾
muv	每种
mv	没有
mva	密切
mvi	没事
mvo	描述
mvu	明确
mvv	每天
na	能力
naa	年纪
nai	脑子
nao	难以
nau	你好
nav	农民
ni	你们
nia	那里
nii	那个
nio	那位
niu	难看
niv	那些
no	难道
noa	耐心
noi	那是
noo	难怪
nou	难道
nov	内部
nu	那么
nua	能够
nui	你的
nuo	难受
nuu	难得
nuv	那种
nv	那样
nva	拿到
nvi	难过
nvo	拿来
nvu	能有
nvv	那天
pa	普通
paa	婆婆
pai	牌子
pao	平淡
pau	旁边
pav	啤酒
pi	配合
pia	苹果
pii	评价
pio	平常
piu	拍摄
piv	拼命
po	漂亮
poa	评论
poi	拍照
poo	便宜
pou	判断
pov	片刻
pu	品牌
pua	排名
pui	片段
puo	评分
puu	平衡
puv	皮肤
pv	朋友
pva	跑到
pvi	匹配
pvo	平均
pvu	排列
pvv	平静
qa	逐渐
qaa	情绪
qai	妻子
qao	针对
qau	正好
qav	去那
qi	其他
qia	其中
qii	整个
qio	正常
qiu	掌握
qiv	整体
qo	其实
qoa	区别
qoi	请问
qoo	确实
qou	正义
qov	情况
qu	准备
qua	着急
qui	真的
quo	全都
quu	期待
quv	青年
qv	正在
qva	轻轻
qvi	主要
qvo	起来
qvu	前面
qvv	清楚
ra	人民
raa	热水
rai	日子
rao	人流
rau	人力
rav	人群
ri	如果
ria	如同
rii	让人
rio	如今
riu	软件
riv	任何
ro	认为
roa	认识
roi	容易
roo	人家
rou	人数
rov	任意
ru	然后
rua	任务
rui	热血
ruo	认真
ruu	日后
ruv	人生
rv	然而
rva	柔软
rvi	人才
rvo	认可
rvu	热烈
rvv	让开
sa	所以
saa	送给
sai	算了
sao	所能
sau	散发
sav	随即
si	随便
sia	送回
sii	四个
sio	思念
siu	随手
siv	宿舍
so	随时
soa	所谓
soi	算是
soo	锁定
sou	随着
sov	速度
su	虽然
sua	四周
sui	碎片
suo	似乎
suu	素质
suv	三种
sv	所有
sva	送到
svi	私下
svo	送来
svu	司机
svv	三天
ta	提出
taa	体验
tai	太阳
tao	天赋
tau	头发
tav	淘汰
ti	他们
tia	听见
tii	推荐
tio	她们
tiu	条件
tiv	停止
to	特别
toa	听说
toi	同时
too	天空
tou	提前
tov	同意
tu	他的
tua	突然
tui	她的
tuo	头脑
tuu	特征
tuv	通知
tv	统一
tva	听到
tvi	通过
tvo	同样
tvu	特殊
tvv	天天
wa	为了
waa	网络
wai	充满
wao	温柔
wau	无力
wav	无法
wi	我们
wia	位置
wii	五个
wio	微信
wiu	文件
wiv	晚上
wo	问题
woa	忘记
woi	温暖
woo	晚安
wou	完美
wov	重新
wu	我的
wua	吃饭
wui	冲向
wuo	充分
wuu	往往
wuv	微笑
wv	完成
wva	无比
wvi	无聊
wvo	未来
wvu	外面
wvv	唯一
xa	喜欢
xaa	系统
xai	行了
xao	学习
xau	幸好
xav	而已
xi	而且
xia	效果
xii	羡慕
xio	相信
xiu	选择
xiv	安全
xo	而是
xoa	谢谢
xoi	像是
xoo	心情
xou	想着
xov	希望
xu	许多
xua	想象
xui	休息
xuo	享受
xuu	显得
xuv	下午
xv	现在
xva	想到
xvi	需要
xvo	下来
xvu	下面
xvv	安静
ya	已经
yaa	预测
yai	样子
yao	游戏
yau	一边
yav	一张
yi	一个
yia	意思
yii	有个
yio	一位
yiu	优势
yiv	一些
yo	因为
yoa	应该
yoi	也是
yoo	一定
you	以为
yov	一次
yu	以后
yua	以外
yui	有的
yuo	一直
yuu	一般
yuv	一种
yv	一样
yva	一切
yvi	一下
yvo	一起
yvu	拥有
yvv	一天
za	自己
zaa	最终
zai	做了
zao	足以
zau	最好
zav	增强
zi	自由
zia	再见
zii	作业
zio	咱们
ziu	责任
ziv	早上
zo	总是
zoa	再说
zoi	暂时
zoo	作品
zou	作为
zov	最新
zu	怎么
zua	作用
zui	走向
zuo	最爱
zuu	最后
zuv	总算
zv	咋样
zva	做到
zvi	坐下
zvo	再来
zvu	坐在
zvv	自动
# 单字
b	不
bb	宾
bba	滨
bbaa	缤
bbaaoo	缤
bbai	濒
bbaivi	濒
bbaooa	滨
bbi	摈
bbia	髌
bbiaoo	髌
bbio	傧
bbioo	镔
bbiooa	傧
bbiooo	镔
bbiuoo	摈
bbiv	豳
bbivua	豳
bbo	斌
bbooui	宾
bbovvv	斌
bbu	膑
bbuo	邠
bbuoai	邠
bbuooa	膑
bbv	彬
bbvi	鬓
bbvioo	鬓
bbvo	槟
bbvooa	槟
bbvu	殡
bbvuoo	殡
bbvv	玢
bbvvuo	玢
bbvvuu	彬
bc	表
bca	婊
bcaa	骠
bcaaa	骉
bcaaaa	骉
bcaavi	骠
bcao	瀌
bcaovu	瀌
bcauvv	婊
bci	彪
bcia	幖
bciavi	幖
bcii	蔈
bciio	藨
bciiov	藨
bciivi	蔈
bcio	镖
bcioo	镳
bcioov	镳
bciov	儦
bciovi	镖
bciovu	儦
bciu	摽
bciuvi	摽
bciv	俵
bcivuu	彪
bcivvi	俵
bco	裱
bcoavv	裱
bcou	熛
bcouvi	熛
bcov	瘭
bcovvi	瘭
bcu	膘
bcuau	飑
bcuaua	飑
bcuav	鳔
bcuavi	鳔
bcuv	脿
bcuvia	膘
bcuvvi	脿
bcv	标
bcvu	飙
bcvua	杓
bcvuao	杓
bcvuua	飙
bcvvua	表
bcvvvi	标
bd	别
bdo	憋
bdoaii	别
bdou	鳖
bdouo	蹩
bdouoa	憋
bdouoi	蹩
bdouua	鳖
bdov	瘪
bdovui	瘪
bdu	癿
bduiaa	癿
bf	办
bfa	绊
bfaaou	绊
bfai	阪
bfaiuu	阪
bfao	湴
bfaouv	湴
bfauoo	办
bfi	搬
bfio	伴
bfiou	钣
bfiouu	钣
bfiouv	伴
bfiu	扳
bfiuo	拌
bfiuou	拌
bfiuu	扮
bfiuuo	扮
bfiuuu	扳 搬
bfo	半
bfoi	昄
bfoiuu	昄
bfouvv	半
bfov	瓣
bfovi	𨭉
bfovio	𨭉
bfovu	瘢
bfovuu	瓣 瘢
bfovv	癍
bfovvv	癍
bfu	版
bfuiuu	版
bfuo	颁
bfuou	攽
bfuouv	攽
bfuovu	颁
bfuu	般
bfuuua	般
bfv	班
bfvi	靽
bfviou	靽
bfvo	坂
bfvou	柈
bfvouu	坂
bfvouv	柈
bfvu	板
bfvuua	板
bfvv	斑
bfvvou	班
bfvvov	斑
bg	并
bga	屏
bgavou	屏
bgi	摒
bgia	蛃
bgiavi	蛃
bgiuav	摒
bgo	病
bgoi	昺
bgoivi	昺
bgou	炳
bgouvi	炳
bgouvv	并
bgov	冰
bgovaa	冰
bgovv	禀
bgovvi	病
bgovvv	禀
bgu	兵
bgua	饼
bguaou	饼
bguiuo	兵
bguv	秉
bguvav	秉
bgv	柄
bgvi	丙
bgvia	邴
bgviai	邴
bgviau	丙
bgvo	槟
bgvooa	槟
bgvou	栟
bgvouv	栟
bgvvia	柄
bh	白
bha	败
bhaouv	败
bhav	擘
bhaviu	擘
bhi	摆
bhiu	拜
bhiui	伯
bhiuia	伯 摆
bhiuu	掰
bhiuui	捭
bhiuuo	掰
bhiuvv	拜
bhiv	佰
bhivuo	佰
bho	呗
bhoaoo	呗
bhu	稗
bhuiav	白
bhuvui	稗
bhv	百
bhvu	柏
bhvuia	柏
bhvuoi	百
bj	部
bji	步
bjii	蔀
bjiiov	蔀
bjio	卜
bjioo	卜
bjiov	钚
bjiovo	堡
bjiovu	钚
bjiu	捕
bjiuvi	捕
bjiviu	步
bjo	补
bjoaio	补
bjoi	晡
bjoio	卟
bjoioo	卟
bjoivi	晡
bjoo	怖
bjoovu	怖
bjov	哺
bjovai	部
bjovia	哺
bjovv	瓿
bjovva	瓿
bju	簿
bjuvav	簿
bjv	布
bjvi	逋
bjvii	醭
bjviii	醭
bjvioa	逋
bjviu	𬷕
bjviua	𬷕
bjvo	埠
bjvoi	埗
bjvoiv	埗
bjvoui	埠
bjvov	埔
bjvovi	埔
bjvuia	布
bjvuio	不
bk	比
bka	避
bkaa	纰
bkaava	纰
bkai	陛
bkaiva	陛
bkao	泌
bkaoa	赑
bkaoao	泌 赑
bkau	婢
bkaui	濞
bkauia	濞
bkauui	婢
bkauv	妣
bkauva	妣
bkauvo	滗
bkav	壁
bkava	嬖
bkavau	沘 嬖
bkavo	辟
bkavoa	避
bkavov	襞 辟
bkavu	臂
bkavuu	臂
bkavv	璧
bkavvo	壁
bkavvu	弼
bkavvv	璧
bki	蔽
bkia	睥
bkiau	髀
bkiaui	睥 髀
bkiav	畀
bkiavu	畀
bkii	蓖
bkiia	薜
bkiiav	薜
bkiio	苾
bkiioa	苾
bkiiou	蔽
bkiiu	荸
bkiiui	萆 蓖
bkiiuo	荸
bkiiv	荜
bkiiva	芘 荜
bkio	铋
bkioa	佖
bkioao	佖
bkiooa	铋
bkiu	俾
bkiuia	俾
bko	必
bkoa	裨
bkoaa	邲
bkoaai	邲
bkoaau	诐
bkoao	祕
bkoaoa	祕
bkoaou	必
bkoaui	裨
bkoi	闭
bkoiv	跸
bkoiva	跸
bkoivi	闭
bkoo	愎
bkooa	咇
bkooao	咇
bkoouv	愎
bkou	弊
bkoua	鄙
bkouai	鄙
bkouu	敝
bkouuv	敝
bkouvu	弊
bkov	庇
bkova	哔
bkovau	吡 哔
bkovi	痹
bkovia	痹
bkovu	庳
bkovui	庳
bkovva	庇
bku	笔
bkua	匕
bkuaa	匕
bkuav	狴
bkuava	狴
bkuavo	鲾
bkui	币
bkuiai	币
bkuii	鼻
bkuiia	鼻
bkuo	贲
bkuoao	贲
bkuu	彼
bkuuau	彼
bkuuv	舭
bkuuva	舭
bkuv	秘
bkuvi	箅
bkuvia	箅
bkuvo	馝
bkuvoa	秘 馝
bkuvu	篦
bkuvui	篦
bkuvuv	笔
bkuvv	秕
bkuvva	筚 秕
bkv	毕
bkva	毙
bkvao	毖
bkvaoa	毖
bkvaua	比
bkvauo	毕
bkvav	坒
bkvavo	坒
bkvavu	毙
bkvo	逼
bkvooa	逼
bkvu	皕
bkvuu	觱
bkvuua	觱
bkvuvu	皕
bkvv	碧
bkvvo	珌
bkvvoa	珌
bkvvvu	碧
bl	拨
bla	波
blaa	驳
blaaui	波
blaauo	驳
blau	泊
blauia	泊
blauo	渤
blauoo	浡 渤
blav	剥
blavi	擘
blavii	剥
blaviu	擘
blavu	艴
blavua	艴
blavv	檗
blavvv	檗
bli	播
blia	嶓
bliauo	嶓
blii	薄
bliia	菠
bliiaa	菠
bliiav	薄
bliiu	蕃
bliiuo	蕃
blio	钵
blioa	𬭛
blioaa	𬭛
blioo	卜
bliou	铂
blioui	铂
bliov	钹
bliovi	镈 钵
bliovu	钹
bliu	伯
bliuau	拨
bliuia	伯
bliuuo	播
bliuv	搏
bliuvi	搏
blo	跛
bloa	啵
bloaa	袯
bloaau	啵 袯
bloi	踣
bloiau	跛
bloiov	踣
bloiu	趵
bloiua	趵
blou	哱
blouoo	哱
blov	亳
blovuv	亳
blu	博
blua	饽
bluau	鲌
bluaui	鲌
bluauo	饽
blui	帛
bluiia	帛
bluiu	魄
bluiui	魄
bluo	勃
bluoa	孛
bluoai	孛
bluoau	勃
bluou	鹁
bluoua	鹁
bluovi	博
bluu	脖
bluuoo	脖
bluuu	舶
bluuua	般
bluuui	舶
bluv	膊
bluva	箔
bluvau	箔
bluvav	簿
bluvia	膊
bluvu	馞
bluvuo	馞
bluvv	簸
bluvvi	簸
blv	玻
blvi	僰
blvii	欂
blviia	欂
blviii	僰
blvu	柏
blvui	礴
blvuia	柏
blvuii	礴
blvuo	桲
blvuoo	桲
blvuu	磻
blvuuo	磻
blvuv	砵
blvuvi	砵
blvvau	玻
bm	变
bma	边
bmaa	编
bmaaoa	编
bmao	贬
bmaoa	𨚕
bmaoai	𨚕
bmaouo	贬
bmaov	汴
bmaovi	汴
bmaovu	弁
bmauoa	边
bmi	便
bmia	蝙
bmiaoa	蝙
bmii	苄
bmiio	萹
bmiioa	萹
bmiiov	苄
bmiu	抃
bmiuov	抃
bmivia	便
bmo	遍
bmoa	扁
bmoaia	扁
bmoao	褊
bmoaoa	遍 褊
bmoi	昪
bmoiao	昪
bmooo	忭
bmooov	忭
bmou	煸
bmouoa	煸
bmov	辩
bmova	辫
bmovaa	辫
bmovao	变
bmovi	卞
bmovio	卞
bmovo	辨
bmovoa	辩
bmovou	辨
bmu	笾
bmua	鳊
bmuaoa	鳊
bmuvau	笾
bmv	鞭
bmviiv	鞭
bmvo	匾
bmvoav	匾
bmvu	砭
bmvuo	碥
bmvuoa	碥
bmvuuo	砭
bn	本
bna	畚
bnaoia	畚
bni	苯
bniivi	苯
bnio	锛
bniovu	锛
bniv	倴
bnivuo	倴
bnu	笨
bnuo	贲
bnuoao	贲
bnuov	坌
bnuovo	坌
bnuv	犇
bnuvuv	犇
bnuvvi	笨
bnv	奔
bnviuo	本
bnvo	栟
bnvou	坋
bnvouo	坋
bnvouv	栟
bnvu	夯
bnvuau	夯
bnvuuo	奔
bp	帮
bpa	绑
bpaavv	绑
bpau	浜
bpauiv	浜
bpi	镑
bpia	蚌
bpiavv	蚌
bpii	蒡
bpiiov	蒡
bpio	傍
bpioov	镑
bpiovo	傍
bpiu	搒
bpiuov	搒
bpo	谤
bpoaov	谤
bpov	𠳐
bpovvv	𠳐
bpu	膀
bpuovo	膀
bpv	邦
bpvo	榜
bpvoo	塝
bpvoov	塝
bpvou	彭
bpvouu	彭
bpvov	棓
bpvovo	榜 棓
bpvu	磅
bpvuov	磅
bpvv	棒
bpvvai	邦
bpvvia	帮
bpvvv	梆
bpvvvv	玤 梆 棒
br	蹦
bra	绷
braauu	绷
bri	崩
bria	蚌
briauu	崩
briavv	蚌
brio	镚
brioia	镚
bro	迸
broa	祊
broaov	祊
broi	嘣
broiai	嘣
broiia	蹦
brouoa	迸
brv	甭
brvo	堋
brvouu	堋
brvov	甏
brvova	甏
brvu	泵
brvuaa	泵
brvuua	甭
brvv	琫
brvvvv	琫
bs	把
bsa	巴
bsaiva	巴
bsau	妭
bsauvu	妭
bsav	灞
bsavoa	灞
bsi	拔
bsia	罢
bsiaa	岜
bsiaai	蚆 岜
bsiavo	罢
bsii	芭
bsiiai	芭
bsiii	菝
bsiiiu	菝
bsio	钯
bsioai	钯
bsiu	扒
bsiuai	把
bsiuo	捌
bsiuoa	捌
bsiuuo	扒
bsiuvu	拔
bso	吧
bsoaiv	吧
bsoi	跋
bsoivu	跋
bsou	叭
bsoua	粑
bsouai	羓 粑
bsouoo	叭
bsov	疤
bsovai	疤
bsu	八
bsua	鲅
bsuaa	鲃
bsuaai	鲃
bsuau	鲌
bsuaui	鲌
bsuavu	鲅
bsui	魃
bsuivu	魃
bsuo	爸
bsuoai	爸
bsuoo	八
bsuv	笆
bsuvai	笆
bsuvu	胈
bsuvua	胈
bsv	霸
bsvi	靶
bsviai	靶
bsvo	坝
bsvoao	坝
bsvovi	霸
bsvu	朳
bsvuoo	朳
bsvv	耙
bsvvai	耙
bw	被
bwa	贝
bwaa	𬇙
bwaaoo	𬇙
bwai	陂
bwaiau	陂
bwaoo	贝
bwav	臂
bwavi	鐾
bwavio	鐾
bwavuu	臂
bwi	北
bwii	蓓
bwiiio	蓓
bwio	倍
bwioa	钡
bwioao	钡
bwiovo	倍
bwiv	背
bwiva	邶
bwivai	邶
bwivo	悲
bwivoa	悲
bwivua	北
bwivuu	背
bwivv	辈
bwivva	辈
bwo	呗
bwoa	褙
bwoaau	被
bwoaiv	褙
bwoaoo	呗
bwoo	悖
bwoouo	悖
bwou	焙
bwouov	焙
bwouv	糒
bwouvi	糒
bwov	庳
bwovui	庳
bwu	备
bwua	惫
bwuaa	狈
bwuaao	狈
bwuaia	备
bwuaoa	惫
bwui	卑
bwuiu	鹎
bwuiua	鹎
bwuiuo	卑
bwuo	勃
bwuoa	孛
bwuoai	孛
bwuoau	勃
bwv	杯
bwvi	鞴
bwvia	鞁
bwviau	鞁
bwvivi	鞴
bwvo	棓
bwvovo	棓
bwvu	碑
bwvui	椑
bwvuia	椑
bwvuo	碚
bwvuov	碚
bwvuui	碑
bwvv	琲
bwvviv	琲
bwvvui	杯
bz	报
bza	剥
bzai	孢
bzaiua	孢
bzao	瀑
bzaoiv	瀑
bzavii	剥
bzi	保
bzii	薄
bziiav	薄
bziii	葆
bziiio	葆
bziiu	苞
bziiua	苞
bzio	堡
bzioo	煲
bzioou	煲
bziovo	堡
bziovv	保
bziu	抱
bziuai	报
bziuua	抱
bziv	龅
bzivua	龅
bzo	宝
bzoa	褓
bzoaio	褓
bzoi	暴
bzoio	曝
bzoioi	曝
bzoiu	趵
bzoiua	趵
bzoivi	暴
bzoovv	宝
bzou	爆
bzouoi	爆
bzouu	炮
bzouua	炮
bzov	褒
bzovio	褒
bzu	包
bzua	饱
bzuaav	包
bzuai	刨
bzuaii	刨
bzuau	鲍
bzuaua	鸨 饱 鲍
bzuo	豹
bzuoua	豹
bzuu	胞
bzuuaa	胞
bzv	雹
bzvoua	雹
bzvu	枹
bzvuaa	枹
c	才
cb	催
cba	翠
cbaa	缞
cbaaov	缞
cbai	漼
cbaiai	漼
cbao	淬
cbaoov	翠
cbaovi	淬
cbi	崔
cbiaio	崔
cbii	萃
cbiiai	催
cbiiov	萃
cbiu	摧
cbiuia	摧
cbo	啐
cboo	悴
cbooov	悴
cboovi	啐
cbou	粹
cbouov	粹
cbov	瘁
cbovi	衰
cbovia	衰
cbovov	瘁
cbu	脆
cbuuav	脆
cbuv	毳
cbuvuv	毳
cbv	璀
cbvo	榱
cbvovi	榱
cbvvia	璀
cd	凑
cdovvv	凑
cdu	腠
cduvvv	腠
cdv	辏
cdvavv	辏
ce	测
ceaaoi	测
cei	侧
ceiaoi	侧
ceo	恻
ceooao	恻
ceu	册
ceuaua	册
ceuv	策
ceuvvi	策
cev	厕
cevu	栅
cevuao	厕
cevuau	栅
cf	参
cfa	骖
cfaaao	骖
cfaouu	参
cfav	孱
cfavai	孱
cfi	餐
cfia	黪
cfiaao	黪
cfiu	掺
cfiuao	掺
cfiv	粲
cfivio	餐
cfivou	粲
cfo	惨
cfoo	惭
cfooao	惨
cfoova	惭
cfou	灿
cfouia	灿
cfu	䅟
cfuvao	䅟
cfv	残
cfvuvv	残
cfvv	蚕
cfvvi	璨
cfvvia	蚕
cfvviv	璨
ch	菜
cha	财
chaovi	财
chi	蔡
chia	睬
chiauo	睬
chii	偲
chiiav	偲
chiiua	蔡
chiiuo	菜
cho	踩
choiuo	踩
chu	采
chua	猜
chuavv	猜
chuo	彩
chuoo	裁
chuoov	裁
chuouu	彩
chuovv	采
chv	材
chviuu	才
chvviu	材
cj	粗
cji	促
cjii	蔟
cjiiov	蔟
cjioiv	促
cjo	蹴
cjoiov	蹴
cjouia	粗
cjov	卒
cjovii	卒
cju	簇
cjua	猝
cjuaov	猝
cjuu	徂
cjuuia	徂
cjuvov	簇
cjv	醋
cjvi	酢
cjviuv	酢
cjvivi	醋
cjvu	蹙
cjvui	殂
cjvuia	殂
cjvuoi	蹙
ck	次
cka	赐
ckai	泚
ckaivi	泚
ckaooi	赐
cki	此
ckia	伺
ckiavo	伺
ckii	茨
ckiii	茈
ckiiiv	茈
ckiiov	茨
ckiiv	莿
ckiivi	莿
ckio	佽
ckiovu	佽
ckiv	雌
ckivio	雌
ckivu	𫚖
ckivua	此 𫚖
cko	词
ckoa	祠
ckoaav	词 祠
ckoi	呲
ckoii	跐
ckoiiv	跐
ckoivi	呲
ckou	慈
ckoua	兹
ckouaa	兹
ckouo	糍
ckouoa	慈
ckouou	糍
ckouu	鹚
ckouua	鹚
ckouv	差
ckouvi	差
ckov	瓷
ckovi	疵
ckoviv	疵
ckovo	粢
ckovou	粢
ckovua	次
ckovva	瓷
cku	辞
ckuvov	辞
ckv	刺
ckviii	刺
ckvu	磁
ckvuou	磁
ckvv	玼
ckvviv	玼
cl	错
cli	搓
clia	嵯
cliaou	嵯
clii	莝
cliiii	莝
clio	锉
clioii	锉
cliovi	错
cliu	挫
cliuii	挫
cliuo	撮
cliuoi	撮
cliuou	搓
cliuv	措
cliuvi	措
cliv	鹾
clivou	鹾
clo	痤
cloi	蹉
cloiou	蹉
clov	瘥
clovii	痤
clovou	瘥
clu	矬
clui	脞
cluiiv	脞
cluv	酂
cluvai	酂
cluvii	矬
clv	磋
clvu	厝
clvuou	磋
clvuvi	厝
clvv	瑳
clvvi	棤
clvvii	棤
clvvou	瑳
cn	岑
cna	涔
cnaiai	涔
cnao	参
cnaouu	参
cniaio	岑
cp	藏
cpa	沧
cpaiaa	沧
cpi	仓
cpia	鸧
cpiaaa	仓
cpiaua	鸧
cpii	苍
cpiia	伧
cpiiaa	伧
cpiiia	苍
cpiivu	藏
cpu	舱
cpuuia	舱
cpv	臧
cpvuvi	臧
cr	曾
cra	层
cravvv	层
cri	嶒
criaou	嶒
cro	蹭
croiou	蹭
croo	噌
crooui	噌
crouoi	曾
cs	擦
csi	拆
csiuoo	擦
csiuuu	拆
cso	嚓
csoooa	嚓
ct	窜
cti	攒
ctio	镩
ctiooo	镩
ctiu	撺
ctiuoo	撺
ctiuuv	攒
cto	蹿
ctoioo	蹿
ctooia	窜
ctu	篡
ctui	爨
ctuivv	爨
ctuo	汆
ctuoaa	汆
ctuv	酂
ctuvai	酂
ctuvao	篡
cw	存
cwa	皴
cwaoau	皴
cwo	忖
cwoi	蹲
cwoiou	蹲
cwoovi	忖
cwv	村
cwva	邨
cwvaai	邨
cwvi	寸
cwvioo	寸
cwvuai	存
cwvvio	村
cy	从
cya	淙
cyaa	骢
cyaaui	骢
cyaooa	淙
cyi	丛
cyii	葱
cyiii	苁 从
cyiiii	苁
cyiiua	葱
cyiivv	丛
cyo	悰
cyoooo	悰
cyou	熜
cyouui	熜
cyu	匆
cyuauu	匆
cyui	囱
cyuiua	囱
cyv	聪
cyvi	枞
cyviii	枞
cyviou	聪
cyvv	琮
cyvvoo	琮
cyvvu	璁
cyvvui	璁
cz	草
cza	漕
czavia	漕
czi	操
czia	螬
cziavi	螬
cziioi	草
cziuoo	操
czo	糙
czouuv	糙
czov	嘈
czovia	嘈
czu	艚
czuuvi	艚
czv	曹
czvioi	曹
czvu	𥕢
czvuvi	𥕢
czvv	槽
czvvia	槽
d	的
db	对
dba	队
dbaiii	队
dbao	怼
dbaooa	怼
dbaovi	对
dbi	镦
dbio	𬭚
dbioov	镦 𬭚
dbo	兑
dboa	祋
dboaua	祋
dbouua	兑
dbovu	敦
dbovuv	敦
dbu	追
dbuioa	追
dbv	堆
dbvoio	堆
dbvu	碓
dbvuio	碓
dc	掉
dca	刁
dcaa	汈
dcaavv	汈
dcavv	刁
dci	钓
dcio	铞
dciooi	铞
dciou	铫
dcioua	钓
dciouo	铫
dciuiv	掉
dco	调
dcoa	叼
dcoaua	调
dcoavv	叼
dcoi	吊
dcoiai	吊
dcoo	窎
dcooua	窎
dcov	凋
dcovua	凋
dcu	雕
dcua	鸟
dcuaio	雕
dcuaoa	鸟
dcuau	鲷
dcuaua	鲷
dcuo	貂
dcuoau	貂
dcv	碉
dcvuua	碉
dd	都
dda	陡
ddaa	绖
ddaava	绖
ddaivo	陡
ddao	叠
ddaoia	叠
ddi	抖
ddia	蝶
ddiao	蚪
ddiaoo	蚪
ddiav	𫶇
ddiavi	蝶 𫶇
ddii	蔸
ddiiui	蔸
ddio	钭
ddiooo	钭
ddiuoo	抖
ddiuv	佚
ddiuvv	佚
ddo	斗
ddoa	谍
ddoau	读
ddoauo	读
ddoavi	谍
ddoi	跌
ddoiu	昳
ddoiuv	跌 昳
ddoiv	蹀
ddoivi	蹀
ddoo	窦
ddoouo	斗 窦
ddov	痘
ddova	咥
ddovao	咥
ddovi	喋
ddovii	喋
ddovvo	痘
ddu	兜
ddua	鲽
dduavi	鲽
ddui	牒
dduiua	兜
dduivi	牒
dduo	爹
dduoai	都
dduou	䏲
dduoua	爹 䏲
dduov	耋
dduova	耋
dduu	瓞
dduuuv	瓞
dduv	迭
dduvoa	迭
dduvu	篼
dduvui	篼
ddv	豆
ddvo	逗
ddvooa	逗
ddvoou	豆
ddvov	堞
ddvova	垤
ddvovi	堞
ddvu	碟
ddvuvi	碟
ddvv	楪
ddvvii	楪
de	得
dei	锝
deiooi	锝
deo	嘚
deouui	嘚
deov	底
deovua	底
deu	德
deuiua	的
deuuoi	得
deuuuo	德
dev	地
devoai	地
df	但
dfa	弹
dfaa	𬘘
dfaaoa	𬘘
dfai	蛋
dfaiia	蛋
dfaio	疍
dfaioi	疍
dfao	淡
dfaoo	赕
dfaoou	赕
dfaoui	淡
dfau	澹
dfauav	澹
dfavou	弹
dfi	担
dfia	眈
dfiaoa	眈
dfiav	嵅
dfiavu	嵅
dfii	萏
dfiiua	萏
dfio	𫢸
dfioiv	但
dfioui	𫢸
dfiu	掸
dfiua	儋
dfiuav	儋
dfiuoi	担
dfiuou	掸
dfo	单
dfoa	诞
dfoaui	诞
dfoi	旦
dfoivv	旦
dfoo	惮
dfooou	惮
dfoou	啖
dfooua	憺
dfooui	啖
dfou	郸
dfouai	郸
dfouia	单
dfouo	𬊤
dfouou	𬊤
dfov	疸
dfovo	瘅
dfovoi	亶 疸
dfovou	瘅
dfu	丹
dfuaov	丹
dfuo	胆
dfuoiv	胆
dfuov	膻
dfuovi	膻
dfuv	氮
dfuvo	箪
dfuvou	氮 箪
dfv	耽
dfvi	聃
dfviia	聃
dfvioa	耽
dfvu	石
dfvuo	殚
dfvuoo	石
dfvuou	殚
dg	定
dgi	盯
dgia	鼎
dgiaav	鼎
dgiav	町
dgiavi	盯 町
dgii	萣
dgiioo	萣
dgio	钉
dgioo	锭
dgiooo	锭
dgiou	铤
dgiouv	铤
dgiovi	钉
dgiv	仃
dgivii	仃
dgo	订
dgoavi	订
dgoo	啶
dgoooa	啶
dgoovi	定
dgov	叮
dgovii	叮
dgovv	疔
dgovvi	疔
dgu	腚
dguooa	腚
dgv	顶
dgvi	丁
dgvii	丁
dgviv	酊
dgvivi	耵 酊
dgvivu	顶
dgvu	碇
dgvuoo	碇
dgvv	玎
dgvvvi	玎
dh	代
dha	逮
dhaa	绐
dhaaa	骀
dhaaao	绐 骀
dhao	怠
dhaoo	迨
dhaooa	怠 迨
dhavoa	逮
dhi	袋
dhiv	贷
dhivao	代 贷
dhivi	黛
dhivia	岱 黛
dhivov	袋
dhivv	傣
dhivvo	垈
dhivvv	傣
dho	呆
dhoa	诒
dhoaao	诒
dhov	呔
dhovuo	呔
dhovv	呆
dhu	待
dhuo	戴
dhuoia	戴
dhuuvo	待
dhv	带
dhva	轪
dhvav	棣
dhvavu	轪
dhvavv	棣
dhviia	带
dhvo	埭
dhvoav	埭
dhvu	歹
dhvua	殆
dhvuao	歹 殆
dhvuo	大
dhvuoo	大
dhvv	玳
dhvva	叇
dhvvav	叇
dhvviv	玳
dj	读
dja	渡
djao	赌
djaouo	赌
djaovu	渡
djau	妒
djauo	渎
djauoa	妒 渎
djav	厾
djavoa	厾
dji	督
djia	睹
djiai	髑
djiaia	髑
djiau	黩
djiauo	睹 黩
djii	芏
djiivo	芏
djio	镀
djioov	镀
djiov	𬭊
djiovv	𬭊
djivia	督
djo	度
djoauo	读
djoi	阇
djoiuo	阇
djou	嘟
djouov	嘟
djovao	度
dju	独
djuaia	独
djui	牍
djuiuo	牍
djuo	都
djuoai	都
djuv	肚
djuva	笃
djuvaa	笃
djuvoo	肚
djuvu	犊
djuvuo	犊
djv	毒
djva	顿
djvavu	顿
djvi	蠹
djvivu	蠹
djvo	堵
djvouo	堵
djvu	椟
djvuoa	椟
djvv	杜
djvvaa	毒
djvvoo	杜
dk	地
dka	滴
dkaa	缔
dkaaov	缔
dkao	翟
dkaoio	翟
dkaovo	滴
dkau	涤
dkauao	涤
dkauo	嫡
dkauou	娣
dkauov	媂 嫡
dki	低
dkia	迪
dkiao	睇
dkiaoa	迪
dkiaou	睇
dkiau	骶
dkiaua	骶
dkiav	䗖
dkiavi	䗖
dkiavu	𬱖
dkii	蒂
dkiiov	蒂
dkiiu	荻
dkiiua	茋 荻
dkiiui	菂
dkio	镝
dkioov	镝
dkiu	抵
dkiuav	低
dkiuo	提
dkiuoi	提
dkiuua	抵
dko	底
dkoa	谛
dkoao	禘
dkoaoi	𬤊
dkoaov	谛 禘
dkoau	诋
dkoaua	诋
dkoi	踶
dkoio	蹢
dkoioi	踶
dkoiov	蹢
dkoo	嘀
dkoovo	嘀
dkou	弟
dkouav	弟
dkouo	递
dkouoa	递
dkouu	羝
dkouua	羝
dkov	帝
dkovia	帝
dkovo	遆
dkovoa	遆
dkovua	底
dku	第
dkua	狄
dkuaa	邸
dkuaai	邸
dkuaou	狄
dkuav	氐
dkuava	氐
dkuiua	的
dkuo	籴
dkuoi	觌
dkuoia	觌
dkuoou	籴
dkuv	敌
dkuvav	第
dkuvi	笛
dkuvia	笛
dkuvuv	敌
dkv	堤
dkva	棣
dkvavv	棣
dkvi	髢
dkviai	髢
dkvio	鞮
dkvioi	鞮
dkvo	坻
dkvoai	地
dkvooi	堤
dkvoua	坻
dkvu	砥
dkvua	柢
dkvuav	柢
dkvuo	碲
dkvuou	䃅
dkvuov	碲
dkvuua	砥
dkvv	玓
dkvvo	𤧛
dkvvov	𤧛
dkvvu	杕
dkvvua	玓
dkvvuo	杕
dl	多
dla	堕
dlaa	驮
dlaavu	驮
dlai	隳
dlaiii	隳
dlaiv	隋
dlaivo	堕
dlaivu	隋
dlao	剟
dlaoii	剟
dli	铎
dlioao	铎
dliu	掇
dliuao	掇
dlo	踱
dloa	咄
dloaa	裰
dloaao	裰
dloaii	咄
dloi	跺
dloiov	踱
dloiua	跺
dloo	惰
dloovu	惰
dlou	哆
dloua	哚
dlouao	哆
dlouav	哚
dlov	度
dlovao	度
dlovo	亸
dlovou	亸
dlu	朵
dlua	剁
dluaa	饳
dluaai	饳
dluaii	剁
dluaua	多
dluavv	朵
dlui	躲
dluiua	躲
dluu	舵
dluuoo	舵
dlv	夺
dlvo	垛
dlvoa	㙍
dlvoao	㙍
dlvoo	柁
dlvooa	柁
dlvou	埵
dlvoua	垛
dlvouv	埵
dlvuvi	夺
dlvv	杕
dlvvuo	杕
dm	点
dma	殿
dmai	阽
dmaiiv	阽
dmao	淀
dmaooa	淀
dmau	滇
dmauoi	滇
dmavua	殿
dmi	电
dmia	典
dmiau	巅
dmiauo	典 巅
dmiavv	电
dmii	佃
dmiiav	佃
dmio	钿
dmioia	钿
dmiu	垫
dmiuo	掂
dmiuov	掂
dmiuvo	垫
dmivoo	点
dmo	店
dmoa	扂
dmoaiv	扂
dmoi	踮
dmoiov	踮
dmoo	惦
dmooov	惦
dmou	奠
dmouvu	奠
dmov	癫
dmova	癜
dmovav	癜
dmoviv	店
dmovuo	癫
dmu	颠
dmua	甸
dmuaia	甸
dmuovu	颠
dmuv	簟
dmuvvi	簟
dmv	碘
dmvo	坫
dmvoiv	坫
dmvu	磹
dmvuia	碘
dmvuvi	磹
dmvv	玷
dmvviv	玷
dmvvo	靛
dmvvoo	琔 靛
dni	扽
dniuva	扽
dp	当
dpa	凼
dpaa	𬍡
dpaaii	凼
dpaavv	𬍡
dpi	党
dpiav	嵅
dpiavu	嵅
dpii	荡
dpiiaa	荡
dpiio	菪
dpiioo	菪
dpio	铛
dpioav	当
dpioio	铛
dpioua	党
dpiu	挡
dpiuio	挡
dpo	裆
dpoa	谠
dpoaio	裆 谠
dpoo	宕
dpoovu	宕
dpu	筜
dpuvio	筜
dpv	档
dpvi	𣗋
dpviou	档 𣗋
dpvo	垱
dpvoio	垱
dpvu	砀
dpvuau	砀
dpvv	珰
dpvvio	珰
dq	丢
dqi	铥
dqiouv	铥
dquvao	丢
dr	等
dra	登
draa	澄
draaou	澄
drao	邓
draoai	邓
draou	凳
draoua	凳
draovo	登
dri	瞪
dria	嶝
driaao	瞪 嶝
drio	镫
drioao	镫
dro	灯
droa	噔
droaou	噔
droi	蹬
droiao	蹬
droiv	戥
droiva	戥
drouvi	灯
druvvo	等
drv	磴
drvuao	磴
drvv	璒
drvvao	璒
ds	大
dsa	妲
dsai	溚
dsaiii	溚
dsao	沓
dsaoii	沓
dsauoi	妲
dsi	打
dsii	荙
dsiivu	荙
dsio	𨱏
dsioii	𨱏
dsiov	𫟼
dsiovu	𫟼
dsiu	搭
dsiuii	搭
dsiuvi	打
dso	瘩
dsoa	褡
dsoaii	褡
dsoi	嗒
dsoiii	嗒
dsoio	阘
dsoioi	阘
dsoiv	跶
dsoivu	跶
dsoo	怛
dsooo	惮
dsoooi	怛
dsooou	惮
dsou	嗲
dsouo	炟
dsouoi	炟
dsouou	嗲
dsov	哒
dsovii	瘩
dsovo	疸
dsovoi	疸
dsovuo	哒
dsu	答
dsuv	笪
dsuviv	答
dsuvoi	笪
dsv	达
dsvi	鞑
dsvio	靼
dsvioi	靼
dsvivu	鞑
dsvo	垯
dsvovu	垯
dsvu	耷
dsvuoa	达
dsvuoo	大
dsvuv	鿎
dsvuvi	耷
dsvuvu	鿎
dt	短
dta	缎
dtaaui	缎
dti	锻
dtia	耑
dtiavu	耑
dtioui	锻
dto	断
dtou	煅
dtouui	煅
dtouuu	断
dtov	端
dtovia	端
dtu	段
dtuiua	段
dtuv	簖
dtuvou	簖
dtuvvo	短
dtv	椴
dtvo	塅
dtvoui	塅
dtvuiv	椴
dtvv	瑖
dtvvui	瑖
dw	顿
dwa	沌
dwavai	沌
dwi	钝
dwia	盹
dwiav	囤
dwiava	盹 囤
dwio	镦
dwioov	镦
dwiova	钝
dwo	吨
dwoi	蹲
dwoio	蹾
dwoiou	蹲
dwoiov	蹾
dwoo	惇
dwooov	惇
dwou	炖
dwouu	嘚
dwouui	嘚
dwouva	炖
dwov	敦
dwovai	吨
dwovuv	敦
dwu	得
dwuu	盾
dwuuo	遁
dwuuoa	遁
dwuuoi	得
dwuuuo	盾
dwv	礅
dwva	趸
dwvaoi	趸
dwvavu	顿
dwvo	墩
dwvoov	墩
dwvu	砘
dwvuov	礅
dwvuu	楯
dwvuuu	楯
dwvuva	砘
dy	动
dya	洞
dyaiav	洞
dyi	董
dyia	峒
dyiaia	峒
dyiav	岽
dyiava	𬟽 岽
dyii	侗
dyiiav	侗
dyiiuv	董
dyo	懂
dyoo	恫
dyooia	恫
dyooii	懂
dyou	咚
dyouao	咚
dyov	冻
dyovva	冻
dyu	冬
dyuaoo	冬
dyui	胴
dyuiav	胴
dyuv	胨
dyuvai	胨
dyuvu	氡
dyuvua	氡
dyv	东
dyva	鸫
dyvaiu	东
dyvaua	鸫
dyvo	垌
dyvoia	垌
dyvu	硐
dyvuia	硐
dyvv	栋
dyvvai	栋
dyvvau	动
dz	到
dza	刀
dzauu	刀
dzav	导
dzavvi	导
dzi	倒
dzia	帱
dziavv	帱
dziu	捣
dziuua	捣
dziuv	捯
dziuva	捯
dzivao	倒
dzo	道
dzoa	祷
dzoau	叨
dzoauu	叨
dzoavv	祷
dzoi	蹈
dzoiuo	蹈
dzoo	悼
dzooa	忉
dzooau	忉
dzooiv	悼
dzouoa	道
dzov	盗
dzovia	盗
dzu	岛
dzua	鱽
dzuaau	鱽
dzuaia	岛
dzuu	舠
dzuuau	舠
dzuv	稻
dzuvu	氘
dzuvui	氘
dzuvuo	稻
dzv	纛
dzvaii	到
dzvv	焘
dzvvia	纛
dzvvoo	焘
e	是
eb	水
ebaa	水
ebi	睡
ebia	帨
ebiaou	帨
ebiauv	睡
ebo	谁
eboa	说
eboaio	谁
eboaou	说
ebu	税
ebuvou	税
ed	收
eda	绶
edaauo	绶
edaiuv	收
edi	手
edio	售
ediooo	售
ediu	授
ediuu	手
ediuuo	授
edo	首
edoo	守
edoovi	守
edou	兽
edouui	首
edouvo	兽
edov	瘦
edovo	熟
edovoo	熟
edovui	瘦
edu	受
edua	狩
eduaoo	狩
eduoao	受
eduu	艏
eduuou	艏
edv	寿
edvvvi	寿
ee	设
eea	涉
eeaivi	涉
eeao	赊
eeaoiv	赊
eeav	滠
eeavii	滠
eei	舍
eeia	蛇
eeiaoo	蛇
eeiav	𪨶
eeiavu	𪨶
eeiu	摄
eeiui	拾
eeiuiv	拾
eeiuu	折
eeiuuu	折
eeiuvi	摄
eeiv	佘
eeivi	畲
eeivia	畬 畲
eeivu	歙
eeivua	歙
eeivuo	舍
eeivvi	佘
eeo	社
eeoaua	设
eeoavo	社
eeoi	阇
eeoiuo	阇
eeoo	慑
eeoovi	慑
eeov	麝
eeovui	麝
eeu	射
eeua	猞
eeuaiv	猞
eeuivi	射
eeuv	舌
eeuvoo	舌
eev	奢
eevo	赦
eevouv	赦
eevu	厍
eevuu	奓
eevuua	奓
eevuuo	奢
eevuva	厍
ef	山
efa	陕
efaa	缮
efaao	骟
efaaoa	骟
efaaou	缮
efai	汕
efaiai	汕
efaivo	陕
efao	赡
efaoua	赡
efau	姗
efauo	嬗
efauov	嬗
efauua	姗
efav	潸
efavvu	潸
efi	擅
efia	蟮
efiaii	山
efiaou	蟮
efiau	嶦
efiaua	嶦
efii	苫
efiiiv	苫
efiiu	芟
efiiua	芟
efio	钐
efiouu	钐
efiu	掺
efiuao	掺
efiuo	掸
efiuou	掞 掸
efiuov	擅
efo	善
efoa	扇
efoaao	扇
efoai	讪
efoaia	讪
efoao	禅
efoaou	禅
efoau	衫
efoauu	衫
efoi	闪
efoiii	闪
efoio	晱
efoiou	晱
efoiu	跚
efoiua	跚
efou	煽
efoua	鄯
efouai	鄯
efouao	糁
efoui	单
efouia	单
efouii	剡
efouoa	煽
efouoo	善
efouu	烻
efouui	烻
efov	疝
efovia	疝
efovv	颤
efovvu	颤
efu	删
efua	鳝
efuaii	删
efuao	鳣
efuaou	鳝
efuaov	鳣
efuo	膳
efuouv	膳
efuov	膻
efuovi	膻
efuu	舢
efuuia	舢
efv	珊
efvo	埏
efvoo	墡
efvoou	𫮃 墡
efvoui	埏
efvu	杉
efvua	栅
efvuau	栅
efvuuu	杉
efvvua	珊
eg	帅
egi	摔
egia	蟀
egiaov	蟀
egiuia	帅
egiuov	摔
ego	率
egov	衰
egovaa	率
egovia	衰
egu	甩
eguavv	甩
eh	晒
ehoivi	晒
ehu	筛
ehua	色
ehuaai	色
ehuviu	筛
ehv	酾
ehvivi	酾
ej	数
eja	书
ejaa	纾
ejaaao	纾
ejaaio	书
ejai	疏
ejaii	隃
ejaiiv	隃
ejaiov	疏
ejaiu	陎
ejaiuv	陎
ejaiv	淑
ejaivv	淑
ejao	赎
ejaouo	赎
ejau	恕
ejaui	婌
ejauiv	婌
ejauoa	恕
ejauu	姝
ejauuv	姝
ejav	属
ejavi	漱
ejavia	漱
ejavo	沭
ejavoo	澍 沭
ejavui	属
eji	叔
ejia	署
ejiau	蜀
ejiaua	蜀
ejiauo	署
ejiav	墅
ejiavo	墅
ejii	竖
ejiia	蔬
ejiiai	蔬
ejiii	薯
ejiiia	薯
ejiiiv	菽
ejiiov	竖
ejiiu	倏
ejiiua	倏
ejio	𬬸
ejiovo	𬬸
ejiu	抒
ejiuao	抒
ejiui	摅
ejiuiv	摅
ejiv	舒
ejiva	鄃
ejivai	鄃
ejivao	叔 舒
ejivu	毹
ejivui	俞
ejivuv	毹
ejo	熟
ejoi	暑
ejoii	曙
ejoiia	曙
ejoiuo	暑
ejouuv	数
ejov	孰
ejovo	庶
ejovoo	熟 庶
ejovua	孰
ejovv	塾
ejovvo	塾
eju	鼠
ejua	殳
ejuaao	殳
ejui	腧
ejuiao	鼠
ejuivu	腧
ejuv	黍
ejuvia	黍
ejuvv	秫
ejuvvo	秫
ejv	树
ejva	输
ejvaiv	输
ejvaov	树
ejvi	束
ejviav	束
ejvo	术
ejvoo	述 术
ejvooa	述
ejvov	梳
ejvova	梳
ejvu	殊
ejvuo	戍
ejvuoo	戍
ejvuuv	殊
ejvv	枢
ejvvi	琡
ejvviv	琡
ejvvuo	枢
ek	时
eka	始
ekaa	驶
ekaaia	驶
ekai	浉
ekaiuv	浉
ekao	湿
ekaoi	湜
ekaoii	湿
ekaoiv	湜
ekau	虱
ekauao	始
ekauia	虱
ekauo	媞
ekauoi	媞
ekav	尸
ekavo	屎
ekavou	屎
ekavu	鸤
ekavua	鸤
ekavuu	尸
eki	使
ekia	史
ekiao	似
ekiaoi	似
ekiav	峙
ekiavo	畤 峙
ekiavu	史
ekii	莳
ekiioi	莳
ekiiu	蓍
ekiiuo	蓍
ekio	食
ekioav	食
ekioo	铈
ekioov	铈
ekiu	师
ekiua	势
ekiuau	势
ekiui	拾
ekiuiv	拾
ekiuo	誓
ekiuoa	逝
ekiuoo	什
ekiuov	誓
ekiuv	拭
ekiuvi	师
ekiuvv	拭
ekiv	仕
ekivia	使
ekivo	侍
ekivoo	仕
ekivov	侍
eko	试
ekoa	诗
ekoai	视
ekoaia	视
ekoao	识
ekoaoi	𬤊
ekoaou	谥 识
ekoav	祏
ekoavo	诗
ekoavu	祏
ekoavv	襫 试
ekoi	匙
ekoiua	匙
ekoiv	嘘
ekoiva	嘘
ekoivi	时 是
ekoo	室
ekooo	实
ekoooo	实
ekoov	恃
ekoova	室
ekoovo	恃
ekou	嗜
ekouov	嗜
ekouv	噬
ekouvo	噬
ekouvu	炻
ekov	市
ekovia	市
ekovu	施
ekovuv	施
eku	十
ekua	狮
ekuaa	鲺
ekuaau	鲺
ekuai	蚀
ekuaia	蚀
ekuaiu	𫚕 狮
ekuao	鲥
ekuaoi	鲥
ekuau	饰
ekuauv	饰
ekuav	氏
ekuava	氏
ekui	鼫
ekuivu	鼫
ekuo	释
ekuoao	释
ekuoo	十
ekuov	弑
ekuovv	弑
ekuv	失
ekuvo	适
ekuvoa	适
ekuvu	舐
ekuvua	舐
ekuvv	矢
ekuvvi	筮 䏡
ekuvvu	失 矢
ekv	事
ekva	轼
ekvavv	轼
ekvi	世
ekvia	贳
ekviao	贳
ekviav	事
ekviiv	世
ekviu	䴓
ekviua	䴓
ekviv	酾
ekvivi	酾
ekvo	士
ekvoa	邿
ekvoai	邿
ekvoi	螫
ekvoia	螫
ekvoo	埘 士
ekvooi	埘
ekvov	柿
ekvovi	柿
ekvu	石
ekvua	豕
ekvuau	豕
ekvuoo	石
ekvuu	殖
ekvuuo	殖
ekvv	式
ekvvi	示
ekvviu	示
ekvviv	式
ekvvu	奭
ekvvuo	奭
ekvvv	栻
ekvvvi	栻
el	说
ela	妁
elauua	妁
eli	铄
elii	蒴
eliiou	蒴
elioua	铄
eliu	搠
eliuou	搠
elo	烁
eloaou	说
elou	朔
elouu	数
elouua	烁
elouuu	朔
elouuv	数
elouv	槊
elouvv	槊
elv	硕
elvuvu	硕
em	双
ema	孀
emaa	骦
emaavo	骦
emai	漴
emaiai	漴
emaoao	双
emauvo	孀
emav	泷
emavua	泷
emv	爽
emvo	霜
emvou	鹴
emvoua	鹴
emvovi	霜
emvu	礵
emvuou	爽
emvuvo	礵
en	神
ena	深
enaa	渗
enaai	绅
enaaia	绅
enaaov	渗
enaau	𬳽
enaauv	𬳽
enao	沈
enaoau	深 沈
enaou	参
enaouu	参
enau	婶
enauoo	婶
enauv	娠
enauvu	娠
eni	伸
enia	申
eniai	屾
eniaia	屾
eniav	瞫
eniavi	瞫
eniavv	申
enii	肾
eniiav	伸
eniio	莘
eniiov	莘
eniiuu	肾
eniiv	葚
eniivi	葚
enio	𬬹
enioia	𬬹
eniu	什
eniuoo	什
eniuv	侁
eniuvi	侁
eno	审
enoa	谌
enoai	谂
enoaia	神
enoaio	谂
enoau	诜
enoauv	诜
enoavi	谌
enoi	呻
enoiav	呻
enoo	慎
enooia	审
enoouo	慎
enou	糁
enouao	糁
enouv	燊
enouvv	燊
enov	哂
enova	瘆
enovao	瘆
enovia	哂
enu	身
enua	鲹
enuaao	鲹
enui	胂
enuiav	身 胂
enuv	矧
enuvav	矧
enuvu	甡
enuvuv	甡
env	甚
enviuo	甚
envu	砷
envui	蜃
envuia	砷 蜃
envv	椹
envvi	珅
envvia	珅
envvii	椹
envvio	棽
ep	上
epa	汤
epaa	绱
epaaio	绱
epaauu	汤
epi	尚
epio	赏
epioao	赏
epioia	尚
epioo	裳
epioov	裳
epiu	伤
epiuva	伤
epivvv	上
epo	商
epoi	晌
epoiui	晌
epou	熵
epouov	熵
epovia	商
epu	觞
epuauv	觞
epv	墒
epvo	垧
epvoi	埫
epvoio	埫
epvoov	墒
epvoui	垧
epvu	殇
epvuuv	殇
eq	刷
eqavii	刷
eqo	唰
eqoavu	唰
eqv	耍
eqvuau	耍
er	生
era	圣
eraa	绳
eraaoi	绳
erai	陞
eraiuv	陞
erao	渑
eraoia	渑
eraovo	圣
eri	省
eria	嵊
eriauv	嵊
eriuia	省
ero	晟
eroi	昇
eroiuv	昇
eroivu	晟
eru	剩
eruu	胜
eruuvv	胜
eruv	升
eruvi	甥
eruvia	眚 甥
eruvii	剩
eruviv	乘
eruvu	牲
eruvui	升
eruvuv	笙 牲
eruvvi	生
erv	声
ervoai	声
ervu	盛
ervuia	盛
es	啥
esa	沙
esaa	纱
esaaiu	纱
esai	鲨
esaii	挲
esaiiu	挲
esaio	裟
esaiov	裟
esaiua	鲨
esaiuo	沙
esi	傻
esii	莎
esiiai	莎
esio	铩
esiouo	铩
esiuia	傻
eso	痧
esoivv	啥
esoo	唼
esoovo	唼
esov	嗄
esovai	痧
esovui	嗄
esu	杀
esua	煞
esuaoo	煞
esuo	刹
esuoii	刹
esuovv	杀
esuv	歃
esuvua	歃
esv	厦
esvo	霎
esvoov	霎
esvu	砂
esvuiu	砂
esvuu	杉
esvuuu	杉
esvuvu	厦
et	拴
eta	涮
etaavu	涮
etiuiv	拴
eto	闩
etoivv	闩
etu	腨
etuiai	腨
etv	栓
etvivv	栓
ew	谁
ewi	瞬
ewiauo	瞬
ewo	吮
ewoaio	谁
ewoaou	吮
ewu	顺
ewuivu	顺
ewuo	舜
ewuoua	舜
ewv	楯
ewvuuu	楯
ex	双
exa	孀
exaa	骦
exaavo	骦
exai	漴
exaiai	漴
exaoao	双
exauvo	孀
exav	泷
exavua	泷
exv	爽
exvo	霜
exvou	鹴
exvoua	鹴
exvovi	霜
exvu	礵
exvuou	爽
exvuvo	礵
ez	少
eza	绍
ezaaau	绍
ezau	邵
ezaua	劭
ezauai	邵
ezauau	劭
ezauo	召
ezauoo	召
ezauv	潲
ezauvi	潲
ezi	捎
ezia	蛸
eziai	睄
eziaio	蛸 睄
ezii	苕
eziiau	苕
eziiu	芍
eziiua	芍
eziuio	捎
eziuou	少
ezo	烧
ezoi	哨
ezoiou	哨
ezouva	烧
ezov	韶
ezovau	韶
ezu	稍
ezua	勺
ezuaoo	勺
ezuu	艄
ezuuio	艄
ezuv	筲
ezuvio	稍 筲
ezv	梢
ezva	柖
ezvauo	柖
ezvi	鞘
ezviio	鞘
ezviou	梢
ezvu	杓
ezvuao	杓
ezvv	玿
ezvvau	玿
f	这
fb	追
fba	坠
fbaa	缀
fbaaao	缀
fbaai	骓
fbaaio	骓
fbaau	缒
fbaaui	缒
fbaivo	坠
fbi	锥
fbio	隹
fbioio	锥
fbiovv	隹
fbiu	揣
fbiuia	揣
fbo	惴
fbooia	惴
fbuioa	追
fbv	赘
fbvi	椎
fbviov	椎
fbvvao	赘
fd	周
fda	洲
fdaa	骤
fdaau	绉
fdaaua	绉
fdaav	纣
fdaavi	骤 纣
fdao	赒
fdaoua	赒
fdaouo	洲
fdau	妯
fdauia	妯
fdauu	婤
fdauua	婤
fdav	粥
fdavi	帚
fdavia	帚
fdavo	昼
fdavoi	昼
fdavou	粥
fdi	胄
fdiauu	胄
fdii	荮
fdiiaa	荮
fdiu	㑇
fdiuaa	㑇
fdo	州
fdoa	诌
fdoaua	诌
fdoo	咒
fdooi	宙
fdooia	宙
fdoou	㤘
fdooua	咒 㤘
fdou	啁
fdouav	啁
fdouoi	州
fdu	皱
fduaau	皱
fduavo	周
fduo	繇
fduoua	繇
fduu	舟
fduuao	舟
fduuu	鸼
fduuua	鸼
fduv	肘
fduvi	籀
fduvio	肘
fduviu	籀
fduvv	缶
fduvvi	缶
fdv	否
fdva	轴
fdvaia	轴
fdvau	辀
fdvauu	辀
fdvi	酎
fdvivi	酎
fdvu	碡
fdvui	不
fdvuio	不
fdvuoo	否
fdvuvv	碡
fe	着
fea	浙
feaiuu	浙
fei	折
feii	蔗
feiiov	蔗
feiiu	著
feiiuo	著
feio	锗
feiouo	锗
feiu	哲
feiui	蛰
feiuia	蜇 蛰
feiuo	晢
feiuoi	晢
feiuoo	哲
feiuuu	折
feo	遮
feoa	褶
feoaao	褶
feoao	谪
feoaov	谪
feoau	褚
feoauo	褚
feou	啫
feouia	着
feouov	啫
feov	鹧
feovi	䗪
feovia	䗪
feovii	戢
feovoa	这 遮
feovua	鹧
feu	者
feuooi	者
fev	辙
feva	辄
fevaov	辙
fevavi	辄
fevo	喆
fevou	赭
fevouo	赭
fevovo	喆
fevu	磔
fevuo	詟
fevuov	詟
fevuua	磔
fevv	柘
fevvuo	柘
ff	反
ffa	泛
ffaa	氾
ffaaaa	氾
ffao	贩
ffaouu	贩
ffauoa	泛
ffi	范
ffia	帆
ffiau	幡
ffiaua	帆
ffiauo	幡
ffiauu	畈
ffii	蕃
ffiia	藩
ffiiaa	范
ffiiau	藩
ffiiu	蘩
ffiiuo	蕃
ffiiuv	蘩
ffio	钒
ffiou	𫔍
ffioua	钒
ffiouo	𫔍
ffo	烦
ffoi	蹯
ffoiuo	蹯
ffou	燔
ffouuo	燔
ffouvu	烦
ffu	饭
ffua	凡
ffuaa	犯
ffuaaa	犯
ffuaoo	凡
ffuauu	饭
ffuo	翻
ffuoao	翻
ffuoi	番
ffuoia	番
ffuou	𬸪
ffuoua	𬸪
ffuu	返
ffuuao	反
ffuuoa	返
ffuv	繁
ffuvaa	繁
ffv	梵
ffvo	墦
ffvouo	墦
ffvu	樊
ffvuu	矾
ffvuua	矾
ffvuvu	樊
ffvv	璠
ffvvua	梵
ffvvuo	璠
fgi	拽
fgiuia	拽
fgv	转
fgvavv	转
fha	翟
fhaoio	翟
fhi	摘
fhia	侧
fhiaoi	侧
fhiua	择
fhiuao	择
fhiuov	摘
fhiv	债
fhivvi	债
fho	宅
fhoo	窄
fhoouv	宅 窄
fhoov	寨
fhoovv	寨
fhov	斋
fhovu	瘵
fhovua	瘵
fhovvu	斋
fhu	祭
fhuavv	祭
fhuo	豸
fhuoou	豸
fj	服
fja	妇
fjaa	缚
fjaaa	绋
fjaaav	绋
fjaai	驸
fjaaiv	驸
fjaav	绂
fjaavi	缚
fjaavu	绂
fjai	附
fjaiiv	附
fjaiv	洑
fjaivu	洑
fjao	赋
fjaov	涪
fjaovi	赙
fjaovo	涪
fjaovv	赋
fjau	浮
fjauav	妇
fjauo	滏
fjauoo	浮
fjauou	㳇 滏
fjav	弗
fjavau	弗
fjavu	艴
fjavua	艴
fji	付
fjia	幅
fjiai	幞
fjiaii	幞
fjiau	蝮
fjiauo	蜉
fjiauv	蝮
fjiav	蝠
fjiava	佛
fjiavo	幅 蝠
fjiavu	罘
fjiavv	蚨
fjii	芙
fjiia	茀
fjiiav	䓛 茀
fjiii	苻
fjiiiv	茯 苻
fjiiu	菔
fjiiua	菔
fjiiuo	莩
fjiiv	莆
fjiivi	芾 黼 莆
fjiivu	芣 黻
fjiivv	芙
fjio	俯
fjiov	𫓧
fjiovu	俯
fjiovv	𫓧
fjiu	扶
fjiua	拂
fjiuav	拂
fjiui	拊
fjiuiv	拊
fjiuo	俘
fjiuoo	俘
fjiuv	抚
fjiuvv	扶 抚
fjiv	伏
fjivi	傅
fjivia	傅
fjivio	付
fjivuo	伏
fjo	府
fjoa	福
fjoai	袱
fjoaio	讣
fjoaiv	袱
fjoav	祓
fjoavo	福
fjoavu	祓
fjoi	咐
fjoii	跗
fjoiiv	跗
fjoiv	趺
fjoivi	咐
fjoivv	趺
fjoo	富
fjooa	怫
fjooav	怫
fjooo	宓
fjoooa	宓
fjoovo	富
fjou	㕮
fjouou	㕮
fjov	腐
fjova	鄜
fjovai	鄜
fjovia	腐
fjoviv	府
fjovv	呋
fjovvu	呋
fju	复
fjua	负
fjuaao	负
fjuai	鲋
fjuaia	服
fjuaiv	鲋
fjuau	孵
fjuaua	凫
fjuauo	孵
fjuav	匐
fjuavo	匐
fjui	阜
fjuiuo	阜
fjuo	父
fjuoa	孚
fjuoai	郛 孚
fjuou	斧
fjuouo	父
fjuouu	斧
fjuov	腑
fjuovu	𫖯 腑
fjuovv	釜
fjuu	腹
fjuuvo	腹
fjuv	符
fjuva	氟
fjuvav	氟
fjuvi	脯
fjuvia	脯
fjuviv	符
fjuvoi	复
fjuvu	馥
fjuvuo	稃
fjuvuv	馥
fjuvv	肤
fjuvvi	簠
fjuvvu	肤
fjv	副
fjva	辅
fjvav	辐
fjvavi	辅
fjvavo	辐
fjvi	覆
fjvia	甫
fjviav	甫
fjviu	敷
fjviuu	覆
fjviuv	敷
fjvo	赴
fjvoii	副
fjvoio	赴
fjvou	垺
fjvouo	垺
fjvua	枹
fjvuaa	枹
fjvuo	桴
fjvuoo	桴
fjvuv	砆
fjvuvv	砆
fjvv	夫
fjvvi	榑
fjvvia	榑
fjvvu	琈
fjvvuo	夫 琈
fjvvv	麸
fjvvvu	韨
fjvvvv	玞 麸
fk	之
fka	治
fkaa	纸
fkaai	滍
fkaaii	滍
fkaao	织
fkaaoo	治
fkaaou	织
fkaau	彘
fkaaua	纸
fkaauo	𫄨
fkaauv	彘
fkai	陟
fkaia	骘
fkaiaa	骘
fkaiiv	陟
fkaiv	沚
fkaivi	沚
fkau	汁
fkaua	泜
fkauav	泜
fkauoo	汁
fkav	滞
fkavii	滞
fkavo	咫
fkavou	咫
fki	指
fkia	置
fkiao	帜
fkiaou	帜
fkiau	蜘
fkiauo	置
fkiauv	帙 蜘
fkiav	峙
fkiava	蛭
fkiavo	畤 峙
fkii	芝
fkiii	芷
fkiiiv	芷
fkiio	黹
fkiioa	芝
fkiiou	𦭜 黹
fkiiu	茋
fkiiua	茋
fkio	锧
fkiouu	锧
fkiov	铚
fkiova	铚
fkiu	值
fkiua	贽
fkiuaa	絷
fkiuao	贽
fkiui	挚
fkiuiu	挚
fkiuo	掷
fkiuoa	伎
fkiuoi	值
fkiuou	掷
fkiuov	摭 擿
fkiuu	执
fkiuua	扺 鸷 指 执
fkiv	止
fkiva	侄
fkivao	侄
fkiviv	止
fko	只
fkoa	识
fkoaa	祁
fkoaai	祁
fkoai	祉
fkoaiv	祉
fkoao	禔
fkoaoi	禔
fkoaoo	之
fkoaou	识
fkoau	祗
fkoaua	祇 祗
fkoi	趾
fkoiiv	趾
fkoio	踯
fkoiou	踯
fkoiov	蹢
fkoiu	踬
fkoiuu	踬
fkoiv	跖
fkoiva	晊
fkoivo	跱
fkoivu	跖
fkoo	窒
fkoou	忮
fkoouo	忮
fkoova	窒
fkou	吱
fkouoa	吱
fkouoo	只
fkov	痔
fkovv	痣
fkovva	痓
fkovvo	庤 痔 痣
fku	知
fkua	旨
fkuao	炙
fkuaoi	旨
fkuaou	觯 炙
fkuav	氏
fkuava	氏
fkuo	直
fkuoa	支
fkuoai	疐 𨙸
fkuoao	支
fkuoia	直
fkuoo	豸
fkuoou	豸
fkuu	质
fkuua	脂
fkuuaa	卮
fkuuao	脂
fkuuav	胝
fkuui	徵
fkuuia	徵
fkuuo	肢
fkuuoa	肢
fkuuuo	质
fkuv	制
fkuvi	稚
fkuvii	制
fkuvio	雉 稚
fkuvo	智
fkuvoi	智
fkuvoo	知
fkuvu	秩
fkuvuo	稙
fkuvuv	秩
fkv	至
fkva	致
fkvaa	郅
fkvaai	郅
fkvao	轵
fkvaou	轵
fkvauv	致
fkvav	轾
fkvava	轾
fkvavo	至
fkvi	职
fkvia	郦
fkviai	郦
fkvii	栉
fkviia	栉
fkviou	职
fkviu	酯
fkviua	酯
fkvo	志
fkvoi	址
fkvoiv	址
fkvooa	志
fkvou	枳
fkvouo	埴 枳
fkvu	枝
fkvuo	植
fkvuoa	枝
fkvuoi	植
fkvuov	榰
fkvuu	殖
fkvuuo	殖
fkvuuu	𬃊
fkvuuv	栀
fkvv	桎
fkvvao	桎
fkvvo	梽
fkvvoo	梽
fl	桌
fla	浊
flaa	濯
flaaov	濯
flaau	缴
flaaui	缴
flai	淖
flaiav	浊
flaivo	淖
flao	浞
flaoa	叕
flaoao	叕
flaoiv	浞
flau	汋
flauao	汋
flav	涿
flavua	涿
fli	捉
flia	佛
fliava	佛
flii	著
fliia	茁
fliiai	茁
fliii	䓬
fliiiv	䓬
fliiuo	著
fliiv	倬
fliivo	倬
flio	镯
flioi	䦃
flioia	镯
flioii	䦃
fliu	拙
fliua	擢
fliuai	拙
fliuao	擢
fliuoi	捉
fliv	卓
flivuo	卓
flivvv	桌
flo	着
floa	诼
floao	禚
floaou	禚
floavu	诼
floi	躅
floii	晫
floiia	躅
floiiv	晫
flou	灼
floui	焯
flouia	着
flouiv	焯
flouua	灼
flov	啄
flovu	𬸦
flovua	啄 𬸦
flv	酌
flvi	棹
flviua	酌
flvivo	棹
flvo	棁
flvouo	棁
flvu	斫
flvuuu	斫
flvv	琢
flvvu	椓
flvvua	椓
flvvvu	琢
fm	装
fma	奘
fmaivu	奘
fmi	撞
fmia	幢
fmiaov	幢
fmio	僮
fmiovo	僮
fmiuov	撞
fmo	状
fmoo	憧
fmooov	憧
fmov	壮
fmova	妆
fmovau	妆
fmovo	戆
fmovoa	戆
fmovov	装
fmovv	庄
fmovvo	壮 庄
fmovvu	状
fmv	桩
fmvovu	桩
fn	分
fna	纷
fnaauo	纷
fnao	瀵
fnaou	翂
fnaouo	翂
fnaouv	瀵
fnau	汾
fnauo	𣸣
fnauoa	汾
fnauoi	𣸣
fni	份
fnii	芬
fniiuo	芬
fniiv	棻
fniivv	棻
fniu	偾
fniuoa	份
fniuoi	偾
fno	粉
fnoo	愤
fnoouo	愤
fnou	粪
fnouo	吩
fnouoa	吩
fnouuo	粉
fnouvi	粪
fnu	氛
fnua	鲼
fnuauo	鲼
fnui	鼢
fnuiuo	鼢
fnuo	忿
fnuoau	分
fnuooa	忿
fnuvuo	氛
fnv	奋
fnvi	酚
fnviuo	酚
fnvo	坟
fnvoov	坟
fnvouo	坋
fnvu	豮
fnvuia	奋
fnvuuo	豮
fnvv	焚
fnvvou	焚
fnvvu	棼
fnvvuo	玢 棼
fp	放
fpa	防
fpaa	纺
fpaaov	纺
fpaiov	防
fpau	妨
fpauov	妨
fpi	仿
fpia	蚄
fpiaov	蚄
fpii	芳
fpiiov	芳
fpio	钫
fpioov	钫
fpiova	仿
fpo	方
fpoa	房
fpoao	访
fpoaov	房 访
fpoi	昉
fpoiov	昉
fpov	邡
fpovai	邡
fpovau	方
fpovuv	放
fpu	彷
fpua	鲂
fpuaov	鲂
fpuo	肪
fpuova	肪
fpuu	舫
fpuuov	彷 舫
fpuv	牥
fpuvov	牥
fpv	坊
fpvo	枋
fpvoov	坊
fpvova	枋
fq	抓
fqi	挝
fqiuuu	抓
fqiuvi	挝
fqu	爪
fquuio	爪
fqv	髽
fqviii	髽
fr	风
fra	缝
fraaua	缝
frao	赗
fraoia	赗
frau	沨
fraua	浲
frauao	浲
frauau	沨
frav	沣
fravvv	沣
fri	峰
fria	蜂
friaua	峰 蜂
friav	崶
friavo	崶
frii	葑
friivo	葑
frio	锋
frioua	锋
friv	俸
friva	酆
frivai	酆
frivvv	俸
fro	疯
froa	讽
froaua	讽
frou	烽
frouua	烽
frov	冯
frovaa	冯
frovua	疯
frovv	唪
frovvv	唪
fru	凤
frua	逢
fruaao	凤
fruaoa	逢
fruauo	风
frv	丰
frvo	封
frvov	堼
frvovi	封
frvovo	堼
frvu	枫
frvuau	枫
frvuu	砜
frvuua	砜
frvv	奉
frvvvi	丰
frvvvv	奉
fs	发
fsa	法
fsao	溠
fsaouv	溠
fsauao	发
fsav	渣
fsavoa	法
fsavoi	渣
fsi	罚
fsia	眨
fsiaoa	罚
fsiau	蚱
fsiauo	眨
fsiauv	蚱
fsiavi	蜡
fsio	铡
fsioao	铡
fsiu	扎
fsiuaa	扎
fsiuo	挓
fsiuoo	挓
fsiuu	拃
fsiuuv	拃
fsiuv	揸
fsiuvo	揸
fsiv	伐
fsivau	伐
fsivv	垡
fsivvo	垡
fso	炸
fsoa	诈
fsoauv	诈
fsoi	阀
fsoii	闸
fsoiia	闸
fsoiiv	阀
fsoiu	哳
fsoiuu	哳
fsoo	咤
fsoooa	咤
fsoou	怍
fsoouv	怍
fsou	咋
fsouu	鲝
fsouua	鲝
fsouuv	炸
fsouv	吒
fsouva	吒
fsouvi	咋
fsov	喳
fsovi	喋
fsovii	喋
fsovoi	喳
fsovu	痄
fsovuv	痄
fsu	乏
fsua	鲊
fsuauv	鲊
fsuav	馇
fsuavo	馇
fsuii	齇
fsuiiv	齇
fsuoao	乏
fsuv	乍
fsuvi	筏
fsuvii	劄
fsuviv	乍 筏
fsv	札
fsva	轧
fsvaa	札
fsvaaa	轧
fsvia	酦
fsviau	酦
fsvo	榨
fsvoi	查
fsvoiv	查
fsvoo	霅
fsvooa	榨
fsvoov	霅
fsvu	栅
fsvuau	栅
fsvuu	砟
fsvuua	奓
fsvuuv	砟
fsvuv	砝
fsvuvi	柞
fsvuvo	碴 砝
fsvuvu	䃎
fsvv	楂
fsvvoi	楂
fsvvv	珐
fsvvvo	珐
ft	转
fta	赚
ftaoou	赚
ftav	沌
ftavai	沌
fti	撰
ftia	颛
ftiav	僎
ftiava	僎
ftiavu	耑 颛
ftiuav	撰
ftiv	传
ftivva	传
fto	啭
ftovai	啭
ftu	篆
ftua	馔
ftuaav	馔
ftuv	䏝
ftuvaa	篆
ftuvva	䏝
ftv	专
ftvavv	转
ftvu	砖
ftvuvv	砖
ftvv	瑑
ftvvaa	瑑
ftvvao	专
fw	飞
fwa	费
fwaa	沸
fwaai	绯
fwaaiv	𬴂 绯
fwaava	沸
fwau	妃
fwaua	淝
fwauai	淝
fwauav	妃
fwauoo	飞
fwavao	费
fwi	非
fwii	菲
fwiiiv	菲
fwiiv	芾
fwiivi	芾
fwio	镄
fwioav	镄
fwiv	斐
fwiva	翡
fwivao	翡
fwivi	蜚
fwivia	蜚
fwivii	剕
fwiviv	非
fwivov	斐
fwivv	棐
fwivvv	棐
fwo	废
fwoa	诽
fwoai	扉
fwoaiv	诽 扉
fwoi	啡
fwoivv	啡
fwoo	悱
fwooiv	悱
fwov	吠
fwovau	废
fwovi	痱
fwoviv	痱
fwovuo	吠
fwu	肥
fwua	狒
fwuaav	狒
fwuai	鲱
fwuaii	朏
fwuaiv	肥 鲱
fwui	腓
fwuivv	腓
fwuv	肺
fwuvia	肺
fwuvv	篚
fwuvvi	篚
fwv	匪
fwvivv	匪
fwvo	霏
fwvoiv	霏
fwvv	榧
fwvviv	榧
fx	装
fxa	奘
fxaivu	奘
fxi	撞
fxia	幢
fxiaov	幢
fxio	僮
fxiovo	僮
fxiuov	撞
fxo	状
fxoo	憧
fxooov	憧
fxov	壮
fxova	妆
fxovau	妆
fxovo	戆
fxovoa	戆
fxovov	装
fxovv	庄
fxovvo	壮 庄
fxovvu	状
fxv	桩
fxvovu	桩
fy	中
fya	终
fyaaua	终
fyi	众
fyia	忠
fyiai	盅
fyiaia	盅
fyiaoa	忠
fyiau	蚣
fyiauo	蚣
fyiavi	中
fyii	仲
fyiiav	仲
fyiii	茽
fyiiii	众 茽
fyio	钟
fyioia	钟
fyiou	锺
fyiouv	锺
fyo	衷
fyoa	冢
fyoavu	冢
fyoi	踵
fyoiuv	踵
fyoo	忪
fyoouo	忪
fyovia	衷
fyu	种
fyua	螽
fyuaia	螽
fyui	肿
fyuiav	肿
fyuu	舯
fyuuia	舯
fyuv	重
fyuvia	种 重
fyuvo	穜
fyuvov	穜
fyv	柊
fyvuao	柊
fz	找
fza	召
fzaa	沼
fzaauo	沼
fzauoo	召
fzi	招
fzia	罩
fziaiv	罩
fzio	钊
fzioa	𬬿
fzioau	𬬿
fzioii	钊
fziuau	招
fziuva	找
fzo	照
fzoa	诏
fzoaa	肇
fzoaau	诏
fzoaav	肇
fzoi	昭
fzoiau	昭
fzoio	曌
fzoioo	照 曌
fzou	着
fzoua	啁
fzouav	啁
fzouia	着
fzouo	嘲
fzouoo	嘲
fzov	旐
fzovuv	旐
fzu	朝
fzua	𬶐
fzuauo	𬶐
fzuo	兆
fzuoau	兆
fzuouu	朝
fzuu	爪
fzuuio	爪
fzuv	笊
fzuvuu	笊
fzv	赵
fzvi	棹
fzvivo	棹
fzvouo	赵
g	个
gb	规
gba	癸
gbaovv	癸
gbau	妫
gbaua	氿
gbauaa	氿
gbauou	妫
gbauu	姽
gbauua	姽
gbi	归
gbia	贵
gbiaao	贵
gbiai	刿
gbiaii	刿
gbiaio	嶲
gbiav	眭
gbiavo	眭
gbiu	傀
gbiuav	归
gbiuia	傀
gbiv	刽
gbiva	郐
gbivai	郐
gbivii	刽
gbo	跪
gboa	诡
gboaua	诡
gboi	闺
gboio	炅
gboiou	炅
gboiu	晷
gboiua	跪 晷
gboivo	闺
gboo	宄
gbooua	宄
gbou	炔
gbouav	炔
gbov	庋
gbovu	廆
gbovui	廆
gbovuo	庋
gbu	鬼
gbua	龟
gbuaia	龟
gbuav	鲑
gbuavo	鲑
gbuavu	鳜
gbui	皈
gbuiao	鬼
gbuiuu	皈
gbuv	簋
gbuvav	簋
gbuvv	筀
gbuvvo	筀
gbv	桂
gbva	轨
gbvaua	轨
gbvi	桧
gbvivv	桧
gbvo	圭
gbvoa	邽
gbvoai	邽
gbvovo	圭
gbvu	硅
gbvuvo	硅
gbvv	柜
gbvva	匦
gbvvai	匦
gbvvav	柜
gbvvia	规
gbvvov	桂
gbvvu	瑰
gbvvui	瑰
gbvvv	珪
gbvvvo	鬶 珪
gd	够
gda	购
gdaa	缑
gdaaia	缑
gdaoua	购
gdau	沟
gdauaa	沟
gdauu	姤
gdauuu	姤
gdauv	媾
gdauvv	媾
gdi	钩
gdia	岣
gdiaua	岣
gdii	苟
gdiiua	苟
gdioua	钩
gdiu	佝
gdiuao	佝
gdiuu	拘
gdiuua	拘
gdo	诟
gdoauu	诟
gdu	狗
gdua	勾
gduaao	勾
gduai	雊
gduaio	雊
gduao	句
gduaoo	句
gduaua	够 狗
gduo	耇
gduoua	耇
gduv	篝
gduvu	笱
gduvua	笱
gduvvv	篝
gdv	构
gdvi	鞲
gdvivv	鞲
gdvo	垢
gdvoa	彀
gdvoav	彀
gdvouu	垢
gdvu	枸
gdvuaa	构
gdvuao	枸
gdvv	觏
gdvvia	觏
gdvvo	遘
gdvvoa	遘
ge	各
gea	隔
geaa	纥
geaauv	纥
geaivo	隔
geau	哿
geauvo	哿
geav	滆
geavoi	滆
gei	葛
geia	骼
geiai	蛤
geiaiv	蛤
geiau	虼
geiaua	骼
geiauv	虼
geiii	个
geiioi	葛
geio	铬
geioua	铬
geiov	镉
geiovo	镉
geiu	搁
geiuoi	搁
geiuv	仡
geiuva	仡
geiv	鸽
geivo	合
geivoo	合
geivua	鸽
geivv	颌
geivvu	颌
geo	割
geoa	袼
geoaua	袼
geoi	阁
geoiua	阁
geooii	割
geou	咯
geouao	咯
geoui	盖
geouia	盖
geov	嗝
geovoi	嗝
geovu	疙
geovuv	疙
geu	胳
geua	饹
geuaoo	各
geuaua	饹
geuu	舸
geuuao	胳
geuuvo	舸
geuv	膈
geuvoi	膈
gev	哥
geva	戈
gevauo	戈
gevi	革
geviia	革
gevo	歌
gevoi	鬲
gevoia	鬲
gevou	圪
gevoua	歌
gevouv	圪
gevov	塥
gevovo	哥 塥
gevu	格
gevuao	格
gevuu	硌
gevuua	硌
gf	干
gfa	敢
gfaa	绀
gfaav	澉
gfaavi	绀 澉
gfai	淦
gfaioo	淦
gfaiv	㽏
gfaivi	㽏
gfav	泔
gfavii	泔
gfavuv	敢
gfi	擀
gfiav	虷
gfiavv	虷
gfii	苷
gfiivi	苷
gfiu	扞
gfiuuo	擀
gfiuvv	扞
gfo	赣
gfoi	旰
gfoivv	旰
gfov	疳
gfovua	赣
gfovvi	疳
gfu	肝
gfua	鳡
gfuavu	鳡
gfuv	竿
gfuvv	秆
gfuvvi	𬕂 肝
gfuvvv	秆 竿
gfv	感
gfva	橄
gfvavi	橄
gfvi	甘
gfviiv	甘
gfviv	酐
gfvivv	酐
gfvo	赶
gfvov	坩
gfvovi	坩
gfvovv	赶
gfvu	尴
gfvuii	尴
gfvuoa	感
gfvuv	矸
gfvuvv	矸
gfvv	杆
gfvvi	柑
gfvvii	干 柑
gfvvv	玕
gfvvvi	杆
gfvvvv	玕
gg	乖
gga	夬
ggavuo	夬
ggi	拐
ggiu	掴
ggiuia	掴
ggiuoa	拐
ggiv	郐
ggivai	郐
ggo	怪
ggooao	怪
gguviv	乖
gh	该
gha	改
ghaa	溉
ghaavv	溉
ghai	陔
ghaii	𬮿
ghaiia	𬮿
ghaiov	陔
ghao	赅
ghaoov	赅
ghau	戤
ghauva	戤
ghavuv	改
ghi	钙
ghii	芥
ghiiiu	芥
ghiio	荄
ghiiov	荄
ghiovi	钙
gho	盖
ghoaov	该
ghoi	晐
ghoiov	晐
ghouia	盖
ghu	胲
ghuova	胲
ghv	概
ghvavv	概
ghvi	丐
ghviva	丐
ghvo	垓
ghvoov	垓
gj	古
gja	姑
gjai	孤
gjaiuu	孤
gjao	汩
gjaoii	汩
gjau	沽
gjauoo	沽
gjauuo	姑
gjav	瀔
gjavoo	瀔
gji	固
gjia	骨
gjiai	蛊
gjiaia	崮 蛊
gjiau	蛄
gjiaua	鹘
gjiauo	罟 固 蛄
gjiauu	骨
gjii	菇
gjiia	菰
gjiiai	菰
gjiiau	菇
gjiiav	䓛
gjiii	蓇
gjiiia	蓇
gjio	锢
gjioia	锢
gjiou	钴
gjiouo	钴
gjiu	估
gjiuoo	估
gjo	雇
gjoa	诂
gjoaio	雇
gjoauo	诂
gjou	咕
gjouoo	咕
gjouu	呱
gjouua	羖 呱
gjov	痼
gjovia	痼
gju	故
gjua	觚
gjuai	鲴
gjuaia	馉 鲴
gjuauu	觚
gjuo	谷
gjuoa	嘏
gjuoav	嘏
gjuoo	辜
gjuooo	古 谷
gjuoov	辜
gjuou	鸪
gjuoua	鸪
gjuouv	故
gjuu	股
gjuuaa	股
gjuuo	𦙶
gjuuoo	𦙶
gjuv	箍
gjuviu	箍
gjuvo	臌
gjuvoo	告 臌
gjuvu	牯
gjuvua	鹄
gjuvuo	牯
gjuvuv	牿
gjv	顾
gjva	轱
gjvauo	轱
gjvi	贾
gjviao	贾
gjviu	酤
gjviuo	酤
gjvo	鼓
gjvoi	瞽
gjvoia	堌 瞽
gjvouo	鼓
gjvov	毂
gjvova	毂
gjvovv	榖
gjvu	梏
gjvuvi	梏
gjvuvu	顾
gl	过
gla	涡
glai	𬇹
glaiav	𬇹
glaoia	涡
gli	国
glia	果
gliai	帼
gliaia	蜾 蝈 帼
gliao	崞
gliaov	崞
gliavv	国 果
glio	锅
gliooi	锅
gliu	掴
gliuia	掴
glo	郭
gloi	呙
gloiau	呙
glou	馘
gloui	粿
glouia	粿
glouvo	馘
glov	裹
glovai	郭
glovia	裹
glua	馃
gluaia	馃
glui	腘
gluiav	腘
gluo	虢
gluoiv	虢
glv	聒
glvioa	过
glviuv	聒
glvo	椁
glvoo	埚
glvooi	埚
glvovo	椁
gm	光
gma	潢
gmai	洸
gmaiou	洸
gmavii	潢
gmioua	光
gmo	广
gmoi	咣
gmoiou	咣
gmovuu	广
gmu	逛
gmua	犷
gmuaoa	逛
gmuaov	犷
gmui	胱
gmuiou	胱
gmv	桄
gmva	𨐈
gmvaio	𨐈
gmviou	桄
gmvo	垙
gmvoio	垙
gmvv	珖
gmvvio	珖
gn	跟
gna	艮
gnavva	艮
gni	茛
gniiav	茛
gno	哏
gnoavv	哏
gnoiav	跟
gnv	根
gnvavv	根
gnvo	亘
gnvoiv	亘
gp	刚
gpa	港
gpaa	纲
gpaaia	纲
gpavii	港
gpi	钢
gpia	岗
gpiaia	岗
gpiaii	刚
gpiau	冈
gpiauo	冈
gpiav	罡
gpiavi	罡
gpioia	钢
gpiu	扛
gpiuvi	扛
gpo	戆
gpov	冮
gpovoa	戆
gpovvi	冮
gpu	缸
gpuv	肛
gpuviv	肛
gpuvv	筻
gpuvvi	缸 筻
gpv	杠
gpvi	㭎
gpviau	㭎
gpvo	堽
gpvoia	堽
gpvou	鿍
gpvoua	鿍
gpvu	矼
gpvuvi	矼
gpvviv	杠
gq	挂
gqi	括
gqiuuv	括
gqiuvo	挂
gqo	寡
gqoa	褂
gqoav	诖
gqoavo	褂 诖
gqoi	剐
gqoiii	剐
gqoovu	寡
gqou	呱
gqouua	呱
gqu	刮
gquu	瓜
gquuao	瓜
gquuu	胍
gquuua	胍
gquv	鸹
gquvii	刮
gquvua	鸹
gqv	卦
gqvo	坬
gqvoio	卦
gqvouu	坬
gqvu	栝
gqvuvi	栝
gr	更
gra	颈
graa	绠
graavi	绠
graovu	颈
grav	浭
gravia	浭
gro	庚
groi	暅
groioo	暅
grou	羹
grouou	羹
grov	哽
grova	赓
grovao	赓
grovav	庚
grovia	哽
grovu	鹒
grovua	鹒
gru	鲠
gruavi	鲠
grv	梗
grvi	耿
grviav	更
grviou	耿
grvo	埂
grvovi	埂
grvu	𬒔
grvuiv	𬒔
grvv	耕
grvvia	梗
grvvvv	耕
gs	嘎
gsa	尕
gsauiu	尕
gsi	伽
gsiauo	伽
gsio	钆
gsioaa	钆
gsiu	尜
gsiuvu	尜
gso	噶
gsoa	咖
gsoauo	咖
gsoi	呷
gsoiav	呷
gsoiio	噶
gsovui	嘎
gsu	旮
gsuaoi	旮
gsuu	胳
gsuuao	胳
gsv	尬
gsva	轧
gsvaaa	轧
gsvo	夹
gsvouv	夹
gsvu	戛
gsvuiu	尬
gsvuva	戛
gt	关
gta	观
gtaa	贯
gtaaao	贯
gtaai	纶
gtaaiu	纶
gtaaiv	毌
gtai	灌
gtaiio	灌
gtao	涫
gtaoi	矜
gtaoia	观
gtaoio	矜
gtaooa	涫
gti	鹳
gtii	莞
gtiio	蒄
gtiioa	蒄
gtiioo	莞
gtiiua	鹳
gtio	倌
gtiooa	倌
gtiu	掼
gtiuaa	掼
gto	官
gtoa	冠
gtoai	祼
gtoaia	祼
gtoavv	冠
gtoo	惯
gtooaa	惯
gtooia	官
gtou	爟
gtouii	爟
gtouvv	关
gtu	管
gtua	馆
gtuai	鳏
gtuaia	鳏
gtuaoo	馆
gtuau	鳤
gtuauv	鳤
gtui	盥
gtuiia	盥
gtuv	罐
gtuvii	罐
gtuvo	筦
gtuvoo	管 筦
gtv	棺
gtvooa	棺
gtvv	瓘
gtvvii	瓘
gtvvo	琯
gtvvoo	琯
gw	给
gwa	滚
gwaa	绲
gwaaiv	给
gwaaoi	绲
gwaovu	滚
gwo	衮
gwovuo	衮
gwu	鲧
gwuaua	鲧
gwv	棍
gwva	辊
gwvaoi	辊
gwvoiv	棍
gwvu	磙
gwvuov	磙
gx	光
gxa	潢
gxai	洸
gxaiou	洸
gxavii	潢
gxioua	光
gxo	广
gxoi	咣
gxoiou	咣
gxovuu	广
gxu	逛
gxua	犷
gxuaoa	逛
gxuaov	犷
gxui	胱
gxuiou	胱
gxv	桄
gxva	𨐈
gxvaio	𨐈
gxviou	桄
gxvo	垙
gxvoio	垙
gxvv	珖
gxvvio	珖
gy	共
gya	弓
gyaa	红
gyaavi	红
gyavaa	弓
gyi	供
gyia	蚣
gyiauo	蚣
gyiu	拱
gyiuvi	拱
gyivii	供
gyo	宫
gyoooo	宫
gyov	唝
gyoviv	唝
gyu	公
gyua	觥
gyuaio	觥
gyui	躬
gyuiav	躬
gyuoao	公
gyuv	肱
gyuvua	肱
gyuvv	𬕂
gyuvvi	𬕂
gyv	工
gyvi	功
gyvia	贡
gyviaa	汞
gyviai	䢼
gyviao	贡
gyviau	功
gyvii	恭
gyviiu	恭
gyviu	攻
gyviua	巩
gyviuo	共
gyviuv	攻
gyvivv	工
gyvu	龚
gyvuv	硔
gyvuvi	龚 硔
gyvv	珙
gyvvvi	珙
gz	高
gza	缟
gzaaov	缟
gzi	搞
gzii	藁
gziivv	藁
gzio	镐
gzioov	镐
gziou	锆
gziouv	锆
gziuov	搞
gzo	糕
gzoa	诰
gzoauv	诰
gzoi	杲
gzoivv	杲
gzou	羔
gzouoo	羔
gzouou	糕
gzov	膏
gzovia	高
gzovuu	膏
gzu	告
gzui	睾
gzuiv	皋
gzuivo	睾
gzuivu	皋
gzuv	稿
gzuva	郜
gzuvai	郜
gzuvo	篙
gzuvoo	告
gzuvov	稿 篙
gzuvu	筶
gzuvuv	筶
gzv	槁
gzvovo	槁
gzvu	槔
gzvuia	槔
h	和
hb	会
hba	汇
hbaa	绘
hbaaiv	绘
hbai	洄
hbaiao	洄
hbaiav	溃
hbaii	隳
hbaiii	隳
hbaiv	浍
hbaivo	堕
hbaivv	浍
hbao	贿
hbaoo	翚
hbaooa	翚
hbaovu	贿
hbavaa	汇
hbi	回
hbia	蛔
hbiaa	翙
hbiaao	翙
hbiai	睢
hbiaia	蛔
hbiaio	睢
hbiaoo	回
hbiav	蟪
hbiavi	蟪
hbii	荟
hbiii	茴
hbiiia	茴
hbiiiv	荟
hbiiv	蕙
hbiivi	蕙
hbio	辉
hbiooa	辉
hbiov	𬭬
hbiovv	𬭬
hbiu	挥
hbiuo	㧑
hbiuoa	挥
hbiuou	㧑
hbivva	会
hbo	恢
hboa	讳
hboaa	喙
hboaav	喙
hboau	诲
hboauv	诲
hboav	诙
hboavi	𬤝
hboavu	诙
hboavv	袆 讳
hboi	晦
hboia	哕
hboiai	哕
hboio	晖
hboioa	晖
hboiuv	晦
hboo	悔
hboouv	悔
hboovu	恢
hbou	烩
hbouiv	烩
hbouv	烠
hbouvu	烠
hbov	麾
hbovu	咴
hbovuo	咴
hbovuv	麾
hbu	毁
hbuiua	毁
hbuo	卉
hbuovu	卉
hbuu	徽
hbuui	徊
hbuuia	徽 徊
hbuv	秽
hbuvia	秽
hbv	灰
hbvi	惠
hbvioa	惠
hbviv	桧
hbvivv	桧
hbvo	恚
hbvooa	恚
hbvu	虺
hbvuia	虺
hbvuou	灰
hbvuu	硊
hbvuua	硊
hbvv	慧
hbvva	彗
hbvvav	彗
hbvvi	橞
hbvvia	橞
hbvvo	珲
hbvvoa	慧 珲
hd	后
hdi	候
hdia	侯
hdiau	骺
hdiauu	骺
hdiavu	侯
hdiiav	候
hdio	𬭤
hdioia	𬭤
hdo	喉
hdoa	吼
hdoaiv	吼
hdoiav	喉
hdoo	鲎
hdooua	鲎
hdou	糇
hdouia	糇
hdouv	吽
hdouvv	吽
hdov	瘊
hdovia	瘊
hdu	猴
hdua	鲘
hduaia	猴
hduauu	鲘
hdui	齁
hduiua	齁
hduu	逅
hduua	郈
hduuai	郈
hduuoa	逅
hduuoo	后
hduuv	垕
hduuvo	垕
hduv	篌
hduvia	篌
hdv	厚
hdvo	堠
hdvoia	堠
hdvuoi	厚
he	合
hea	河
heaa	纥
heaauv	纥
heai	涸
heaiau	涸
heao	渴
heaoiu	渴
heaoo	翯
heaoov	翯
heau	贺
heauao	贺
heavoi	河
hei	何
heii	荷
heiia	菏
heiiav	菏
heiiiv	荷
heiv	盒
heiva	郃
heivai	郃
heivia	盒
heivoi	何
heivoo	合
heivu	龁
heivuv	龢 龁
heivv	壑
heivvo	壑
heivvu	颌
heo	喝
heoa	鹤
heoao	褐
heoaoi	褐
heoaua	鹤
heoaui	隺
heoav	诃
heoavo	诃
heoi	嗬
heoiii	嗬
heoio	阂
heoiov	阂
heoiu	曷
heoiua	鹖 曷
heoiv	阖
heoivo	阖
heooiu	喝
heou	熇
heouov	熇
heov	呵
heova	劾
heovau	劾
heovi	吓
heovio	吓
heovoi	呵
heu	禾
heua	饸
heuaiv	饸
heuo	貉
heuoua	貉
heuv	盉
heuvia	盉
heuviu	禾
heuvoo	和
hev	核
heva	𬌗
hevaiv	𬌗
hevi	鞨
hevioi	鞨
hevo	赫
hevoa	翮
hevoao	翮
hevoi	盍
hevoia	盍
hevou	垎
hevoua	垎
hevova	核
hevovo	赫
hf	汉
hfa	汗
hfaa	涵
hfaaio	涵
hfaaoo	汉
hfai	函
hfaiai	函
hfaio	浛
hfaioa	浛
hfau	瀚
hfauoo	瀚
hfav	憨
hfavoa	憨
hfavvi	汗
hfi	含
hfia	蚶
hfiaa	崡
hfiaai	崡
hfiav	虷
hfiavi	蚶
hfiavu	嵅
hfiavv	虷
hfii	菡
hfiiai	菡
hfiio	蔊
hfiiou	蔊
hfio	颔
hfiooo	含
hfiovu	颔
hfiu	撼
hfiua	撖
hfiuav	撖
hfiuo	捍
hfiuoi	捍
hfiuv	扞
hfiuvu	撼
hfiuvv	扞
hfo	喊
hfoa	罕
hfoavv	罕
hfoi	旱
hfoia	阚
hfoiav	阚
hfoii	晗
hfoiio	晗
hfoiv	暵
hfoivi	暵
hfoivv	旱
hfoo	寒
hfooi	㘎
hfooia	㘎
hfooo	悍
hfoooi	悍
hfoooo	寒
hfoov	憾
hfoovu	憾
hfou	焊
hfoui	焓
hfouio	焓
hfouoi	焊
hfovuv	喊
hfu	韩
hfua	犴
hfuavv	犴
hfui	鼾
hfuivv	鼾
hfuo	翰
hfuoia	翰
hfuovv	韩
hfv	酣
hfvi	邯
hfviai	邯
hfvivi	酣
hfvo	垾
hfvooi	垾
hfvv	顸
hfvva	邗
hfvvai	邗
hfvvi	琀
hfvvio	琀
hfvvvu	顸
hg	坏
hga	淮
hgaiov	淮
hgo	怀
hgoi	踝
hgoiia	踝
hgoovu	怀
hgu	徊
hguuia	徊
hgv	槐
hgvovu	坏
hgvuia	槐
hh	还
hha	海
hhaa	骇
hhaaov	骇
hhai	孩
hhaiov	孩
hhauva	海
hhi	骸
hhiaov	骸
hho	害
hhoa	嗨
hhoao	咍
hhoaoo	咍
hhoauv	嗨
hhoo	咳
hhooo	嗐
hhoooa	嗐
hhoova	咳
hhoovv	害
hhov	亥
hhovau	亥
hhu	氦
hhuo	胲
hhuova	胲
hhuvov	氦
hhv	醢
hhvivu	醢
hhvuoa	还
hj	胡
hja	湖
hjai	滹
hjaiva	滹
hjao	沪
hjaoa	浒
hjaoau	浒
hjaoav	沪
hjaov	戏
hjaova	戏
hjau	淴
hjauau	淴
hjaui	嫭
hjauiv	嫭
hjauoo	湖
hjav	弧
hjavuu	弧
hji	护
hjia	蝴
hjiau	鹘
hjiaua	囫 鹘
hjiauo	岵 蝴
hjii	葫
hjiiu	芴
hjiiua	芴
hjiiuo	葫
hjiuoa	护
hjiv	虎
hjivua	虎
hjo	户
hjoa	扈
hjoao	戽
hjoaoa	扈
hjoaoo	戽
hjoau	祜
hjoaui	隺
hjoauo	祜
hjoauv	许
hjoavu	户
hjoi	唬
hjoio	昈
hjoioa	昈
hjoiu	昒
hjoiua	昒
hjoiva	唬
hjoo	惚
hjoou	怙
hjooua	惚
hjoouo	怙
hjou	呼
hjoua	唿
hjouau	唿
hjouou	呼
hjouu	糊
hjouuo	煳 烀 糊
hjov	冱
hjovva	冱
hju	乎
hjua	忽
hjuai	鹱
hjuaii	鳠 鹱
hjuao	斛
hjuaoa	忽
hjuaoo	斛
hjuau	狐
hjuauo	猢
hjuauu	狐
hjuo	鹕
hjuoua	鹕
hjuouu	胡
hjuouv	乎
hjuv	鹄
hjuvoo	和
hjuvu	笏
hjuvua	鹄 笏
hjv	互
hjva	轷
hjvaav	互
hjvauo	轷
hjvi	醐
hjviuo	醐
hjvo	壶
hjvoa	鄠
hjvoaa	縠
hjvoai	鄠
hjvoii	壶
hjvou	觳
hjvoua	觳
hjvov	核
hjvova	核
hjvu	槲
hjvuau	槲
hjvuu	瓠
hjvuuu	瓠
hjvv	瑚
hjvvi	琥
hjvviv	琥
hjvvuo	瑚
hl	或
hla	活
hlaa	𬴃
hlaavv	𬴃
hlai	濩
hlaiii	濩
hlao	漷
hlaovo	漷
hlauvi	活
hlav	彟
hlavii	彟
hli	获
hlia	夥
hliai	蠖
hliaii	蠖
hliaua	夥
hlii	藿
hliii	劐
hliiii	劐
hliiua	获
hliivo	藿
hlio	伙
hlioi	镬
hlioii	镬
hlioo	钬
hlioou	钬
hliou	锪
hlioua	锪
hlioui	伙
hliu	货
hliuao	货
hliuv	攉
hliuvi	佸
hliuvo	攉
hlo	火
hloa	祸
hloaoi	祸
hloi	嚄
hloiii	嚄
hloo	豁
hloouo	豁
hlou	㸌
hlouii	火
hlouvo	㸌
hlov	嚯
hlovoa	嚯
hluvoo	和
hlv	霍
hlvo	惑
hlvoio	霍
hlvooa	惑
hlvova	或
hlvv	耠
hlvviv	耠
hm	黄
hma	隍
hmaiui	隍
hmao	滉
hmaoii	滉
hmau	湟
hmauia	湟
hmauu	媓
hmauui	媓
hmav	潢
hmavii	潢
hmi	荒
hmia	幌
hmiaoi	幌
hmiau	蝗
hmiaui	蝗
hmiav	蟥
hmiavi	蟥
hmiiov	荒
hmio	锽
hmioui	锽
hmiov	𨱑
hmiovi	𨱑
hmo	慌
hmoa	谎
hmoaii	谎
hmoi	晃
hmoiio	晃
hmoo	惶
hmooi	恍
hmooii	慌
hmooio	恍
hmooui	惶
hmou	煌
hmoui	喤
hmouia	喤
hmouui	煌
hmov	肓
hmovuu	肓
hmovv	癀
hmovvi	癀
hmu	皇
hmua	凰
hmuau	鳇
hmuaui	凰 鳇
hmui	遑
hmuii	㿠
hmuiio	㿠
hmuioa	遑
hmuivv	皇
hmuu	徨
hmuuu	艎
hmuuui	徨 艎
hmuv	簧
hmuvu	篁
hmuvui	篁
hmuvvi	簧
hmviia	黄
hmvv	璜
hmvvu	瑝
hmvvui	瑝
hmvvvi	璜
hn	很
hno	恨
hnoa	哏
hnoaa	𬣳
hnoaav	𬣳
hnoavv	哏
hnooav	恨
hnov	痕
hnovav	痕
hnu	狠
hnuaav	狠
hnuuav	很
hp	行
hpa	沆
hpaa	绗
hpaauu	绗
hpaovu	沆
hpo	吭
hpoovu	吭
hpov	颃
hpovu	亢
hpovua	亢
hpovvu	颃
hpu	航
hpuuov	航
hpuuvv	行
hpv	杭
hpvi	巷
hpviav	巷
hpvovu	杭
hpvu	夯
hpvuau	夯
hpvuu	桁
hpvuui	桁
hpvv	珩
hpvvuu	珩
hq	话
hqa	滑
hqaa	骅
hqaaiu	骅
hqaiaa	滑
hqau	婳
hqauvi	婳
hqi	化
hqii	花
hqiiiu	花
hqio	铧
hqioiu	铧
hqiu	华
hqiuaa	化
hqiuuo	华
hqo	哗
hqoauv	话
hqoiua	哗
hqoo	豁
hqoouo	豁
hqu	猾
hqua	觟
hquaia	猾
hquavo	觟
hqv	划
hqvaii	划
hqvi	画
hqviav	画
hqviu	桦
hqviua	桦
hqvv	砉
hqvvvu	砉
hr	横
hra	姮
hrauvo	姮
hri	蘅
hriiuu	蘅
hro	哼
hroo	恒
hroovo	哼 恒
hrov	亨
hrovai	亨
hru	衡
hruu	鸻
hruuua	衡 鸻
hruuv	行
hruuvv	行
hrv	珩
hrvo	堼
hrvovo	堼
hrvu	桁
hrvuui	桁
hrvvii	横
hrvvuu	珩
hs	哈
hsi	蛤
hsia	虾
hsiaiv	蛤
hsiavi	虾
hsio	铪
hsioiv	铪
hso	呵
hsoivo	哈
hsovoi	呵
ht	换
hta	缓
htaa	幻
htaaaa	幻
htaai	缳
htaaia	缳
htaao	𬘫
htaaoo	𬘫
htaauo	缓
htai	漶
htaia	澴
htaiai	澴
htaiav	漶
htao	欢
htaoo	浣
htaooa	浣
htaoua	欢
htau	涣
htauai	涣
htaui	嬛
htauia	嬛
htav	洹
htavoi	洹
hti	患
htia	圜
htiaia	圜
htiaoa	患
htiau	鹮
htiaua	鹮
htiav	峘
htiavo	峘
htii	萑
htiiio	萑
htiiv	荁
htiivo	荁
htio	锾
htioi	镮
htioia	镮
htiouo	锾
htiu	擐
htiuia	擐
htiuua	换
hto	唤
htoi	㬊
htoiuo	㬊
htoo	宦
htooi	寰
htooia	寰
htooo	逭
htoooa	逭
htoovi	宦
htou	焕
htouai	唤
htouua	焕
htouv	豢
htouvu	豢
htov	痪
htovua	痪
htu	奂
htua	獾
htuaa	郇
htuaai	郇
htuaia	奂
htuaii	獾
htuao	鲩
htuaoo	鲩
htuo	貆
htuovo	貆
htv	还
htvi	鬟
htviia	鬟
htvo	垸
htvooo	垸
htvuoa	还
htvv	环
htvvo	桓
htvvoi	桓
htvvu	𤩽
htvvuo	𤩽
htvvvu	环
hw	黑
hwa	混
hwai	溷
hwaiav	溷
hwao	浑
hwaoav	浑
hwaoiv	混
hwau	婚
hwauo	婫
hwauoi	婫
hwauua	婚
hwi	荤
hwiaoo	黑
hwiiva	荤
hwio	𬭶
hwioia	𬭶
hwo	嘿
hwoa	诨
hwoaoa	诨
hwoau	嗨
hwoauv	嗨
hwoi	阍
hwoiao	嘿
hwoiua	阍
hwoo	惛
hwooua	惛
hwu	昏
hwua	馄
hwuaoi	昏 馄
hwv	魂
hwvu	碈
hwvuua	碈
hwvv	珲
hwvvoa	珲
hwvvui	魂
hx	黄
hxa	隍
hxaiui	隍
hxao	滉
hxaoii	滉
hxau	湟
hxauia	湟
hxauu	媓
hxauui	媓
hxav	潢
hxavii	潢
hxi	荒
hxia	幌
hxiaoi	幌
hxiau	蝗
hxiaui	蝗
hxiav	蟥
hxiavi	蟥
hxiiov	荒
hxio	锽
hxioui	锽
hxiov	𨱑
hxiovi	𨱑
hxo	慌
hxoa	谎
hxoaii	谎
hxoi	晃
hxoiio	晃
hxoo	惶
hxooi	恍
hxooii	慌
hxooio	恍
hxooui	惶
hxou	煌
hxoui	喤
hxouia	喤
hxouui	煌
hxov	肓
hxovuu	肓
hxovv	癀
hxovvi	癀
hxu	皇
hxua	凰
hxuau	鳇
hxuaui	凰 鳇
hxui	遑
hxuii	㿠
hxuiio	㿠
hxuioa	遑
hxuivv	皇
hxuu	徨
hxuuu	艎
hxuuui	徨 艎
hxuv	簧
hxuvu	篁
hxuvui	篁
hxuvvi	簧
hxviia	黄
hxvv	璜
hxvvu	瑝
hxvvui	瑝
hxvvvi	璜
hy	红
hya	洪
hyaa	泓
hyaav	纮
hyaava	泓
hyaavi	红
hyaavu	纮
hyav	鸿
hyava	弘
hyavao	弘
hyavii	洪
hyavua	鸿
hyi	虹
hyiavi	虹
hyii	薨
hyiia	荭
hyiiaa	荭
hyiiv	蕻
hyiivi	蕻
hyiivu	薨
hyio	𫟹
hyioo	𬭎
hyiooo	𬭎
hyiovi	𫟹
hyo	宏
hyoa	讧
hyoavi	讧
hyoi	闳
hyoivu	闳
hyoo	黉
hyoovi	黉
hyoovu	宏
hyou	烘
hyouv	吽
hyouvi	烘
hyouvv	吽
hyov	哄
hyovii	哄
hyovv	竑
hyovvu	竑
hyu	訇
hyuaov	訇
hyuo	谼
hyuovi	谼
hyv	轰
hyvaao	轰
hyvu	翃
hyvuao	翃
hyvuv	硔
hyvuvi	硔
hyvv	玒
hyvvvi	玒
hz	好
hza	浩
hzao	濠
hzaoi	灏
hzaoio	灏
hzaoiv	淏
hzaovo	濠
hzauai	好
hzauvi	浩
hzi	蒿
hzia	蚝
hziauv	蚝
hzii	薅
hziiau	薅
hziiov	蒿
hzio	镐
hzioov	镐
hziv	侴
hzivai	侴
hzo	号
hzoi	昊
hzoii	嚆
hzoiio	嚆
hzoiv	颢
hzoivu	颢
hzoivv	昊
hzoo	嚎
hzoovo	嚎
hzou	嗥
hzouia	嗥
hzov	毫
hzova	鄗
hzovaa	号
hzovai	鄗
hzovuv	毫
hzovv	豪
hzovvu	豪
hzu	皓
hzui	皞
hzuiui	皞
hzuiuv	皓
hzuo	貉
hzuoua	貉
hzv	耗
hzvo	郝
hzvoai	郝
hzvoo	壕
hzvoov	壕
hzvvuv	耗
j	就
jb	进
jba	尽
jbaa	浸
jbaav	津
jbaavi	缙
jbaavu	浕
jbaavv	浸 津
jbai	卺
jbaiaa	卺
jbao	劲
jbaoa	赆
jbaoau	劲
jbaoav	赆
jbaoi	矜
jbaoio	矜
jbau	妗
jbauio	妗
jbav	溍
jbavii	溍
jbavoo	尽
jbi	金
jbia	仅
jbiai	巾
jbiaii	巾
jbiaoo	仅
jbii	紧
jbiia	荩
jbiiaa	紧
jbiiav	荩
jbio	今
jbioaa	今
jbioo	金
jbiou	锦
jbioui	锦
jbiouu	𬬱
jbo	谨
jboa	襟
jboaa	祲
jboaav	祲
jboai	衿
jboaio	衿
jboavi	谨
jboavv	襟
jbou	烬
jbouav	烬
jbov	噤
jbovv	廑
jbovvi	廑
jbovvv	噤
jbu	近
jbua	馑
jbuavi	馑
jbuu	斤
jbuuoa	近
jbuuvi	斤
jbuv	筋
jbuvua	筋
jbv	禁
jbvi	晋
jbvii	觐
jbviia	堇 觐
jbvioi	晋
jbviu	靳
jbviuu	靳
jbvo	墐
jbvovi	墐
jbvu	殣
jbvuvi	殣
jbvv	瑾
jbvva	珒
jbvvav	珒
jbvvi	槿
jbvvii	槿
jbvvoa	进
jbvvv	琎
jbvvvi	瑨 瑾
jbvvvv	禁 琎
jc	叫
jca	缴
jcaa	骄
jcaai	剿
jcaaii	剿
jcaao	绞
jcaaov	绞
jcaaui	缴
jcaauv	骄
jcao	滘
jcaoau	滘
jcau	娇
jcauo	姣
jcauov	漖 姣
jcauuv	娇
jcauv	湫
jcauvi	湫
jcav	浇
jcavau	浇
jci	焦
jcia	蛟
jciao	峧
jciaov	蛟 峧
jciau	峤
jciauv	峤
jcii	蕉
jciiio	蕉
jciio	茭
jciiov	僬 茭
jciiu	艽
jciiua	艽
jciiui	藠
jcio	佼
jcioo	铰
jciooo	焦
jcioov	铰
jciou	鹪
jcioua	鹪
jciovu	佼
jciu	搅
jciuoo	搅
jciv	侥
jcivau	侥
jco	交
jcoaii	叫
jcoi	跤
jcoio	噍
jcoiov	跤 噍
jcoo	觉
jcooia	觉
jcooo	恔
jcooov	恔
jcoou	窖
jcoouv	窖
jcou	嚼
jcoui	燋
jcouio	燋
jcouoo	嚼
jcov	郊
jcovai	郊
jcovu	䴔
jcovua	䴔
jcovuo	交
jcu	教
jcua	角
jcuao	饺
jcuaov	狡 鲛 饺
jcuaua	角
jcui	皎
jcuiov	皎
jcuiu	敫
jcuiui	皦
jcuiuo	皭
jcuiuv	敫
jcuo	胶
jcuouv	教
jcuovu	胶
jcuu	徼
jcuuui	徼
jcuv	脚
jcuvoa	脚
jcuvu	矫
jcuvuv	矫
jcv	较
jcva	轿
jcvaov	较
jcvauv	轿
jcvi	椒
jcvii	醮
jcviio	醮
jcviu	酵
jcviuo	酵
jcvivv	椒
jcvo	校
jcvovu	校
jcvu	礁
jcvuio	礁
jcvv	璬
jcvvo	斠
jcvvoo	斠
jcvvui	璬
jd	接
jda	姐
jdaa	结
jdaavo	结
jdai	阶
jdaii	岊
jdaiia	岊
jdaiiu	阶
jdaiv	孑
jdaivv	孑
jdau	婕
jdauia	姐
jdauva	婕
jdav	洁
jdava	湝
jdavau	湝
jdavi	届
jdavia	届
jdavoo	洁
jdi	节
jdia	界
jdiai	蚧
jdiaiu	骱 界 蚧
jdiav	睫
jdiava	睫
jdiavo	蜐
jdii	藉
jdiiai	节
jdiii	芥
jdiiiu	芥
jdiiu	价
jdiiui	价
jdiivv	藉
jdio	偈
jdioiu	偈
jdiu	介
jdiuii	介
jdiuo	揭
jdiuoi	揭
jdiuov	接
jdiuv	捷
jdiuva	捷
jdiuvo	拮
jdiv	借
jdivii	借
jdo	竭
jdoa	诫
jdoao	褯
jdoaov	褯
jdoav	诘
jdoavo	诘
jdoavv	讦 诫
jdoo	嗟
jdoouv	嗟
jdoov	悈
jdoova	寁
jdoovu	家
jdoovv	悈
jdou	羯
jdouoi	羯
jdov	疥
jdova	疖
jdovai	疖
jdovau	喈
jdoviu	疥
jdovoi	竭
jdu	解
jdua	桀
jduaau	解
jduav	鲒
jduavo	鲒
jduavv	桀
jduo	截
jduoio	截
jduu	街
jduuvo	街
jduv	秸
jduvvo	秸
jdv	杰
jdva	皆
jdvaui	皆
jdvo	劫
jdvoa	劼
jdvoau	劫 劼
jdvooo	杰
jdvov	颉
jdvovu	颉
jdvu	檞
jdvuau	檞
jdvuo	碣
jdvuoi	碣
jdvv	戒
jdvva	楷
jdvvaa	絜
jdvvau	㛃 楷
jdvvi	玠
jdvviu	玠
jdvvo	桔
jdvvoo	桔
jdvvui	戒
je	车
jea	澈
jeaova	澈
jeav	尺
jeavuo	尺
jei	撤
jeiu	扯
jeiuiv	扯
jeiuov	撤
jeo	㬚
jeoiov	㬚
jeu	彻
jeuuva	彻
jeuv	掣
jeuviu	掣
jev	坼
jevavi	车
jevouu	坼
jevu	砗
jevuva	砗
jf	产
jfa	缠
jfaa	潺
jfaaa	骣
jfaaav	骣
jfaaov	缠
jfaavu	潺
jfao	澶
jfaov	浐
jfaovi	澶
jfaovo	浐
jfaovu	瀍
jfau	婵
jfauou	婵
jfav	孱
jfavai	孱
jfavo	羼
jfavou	羼
jfi	掺
jfia	蝉
jfiao	辿
jfiaoa	辿
jfiaou	蝉
jfiau	蟾
jfiaua	巉 蟾
jfii	蒇
jfiivu	蒇
jfio	铲
jfioov	铲
jfiou	镵
jfioua	镵
jfiov	镡
jfiovi	镡
jfiu	搀
jfiua	儳
jfiuao	掺 儳
jfiuua	搀
jfiv	觇
jfivia	觇
jfo	颤
jfoa	谄
jfoao	禅
jfoaou	禅
jfoau	谗
jfoaua	襜 谄 谗
jfoi	阐
jfoii	旵
jfoiia	旵
jfoio	躔
jfoiou	阐
jfoiov	躔
jfoo	忏
jfoou	啴
jfooui	啴
jfoouv	忏
jfou	单
jfoua	冁
jfouav	冁
jfouia	单
jfouo	𬊤
jfouou	𬊤
jfov	廛
jfovia	廛
jfovou	产
jfovvu	颤
jfu	馋
jfuaua	馋
jfv	刬
jfvi	韂
jfviua	韂
jfvu	梴
jfvuiv	梴
jfvvii	刬
jg	经
jga	劲
jgaa	泾
jgaaao	经
jgaaov	泾
jgai	阱
jgaivv	阱
jgao	颈
jgaoau	劲
jgaoi	刭
jgaoii	刭
jgaoo	迳
jgaooa	迳
jgaovu	颈
jgau	婧
jgauvv	婧
jgavv	汫
jgavvu	汫
jgi	警
jgia	睛
jgiavv	睛
jgii	敬
jgiia	茎
jgiiao	茎
jgiii	荆
jgiiii	荆
jgiiiu	儆
jgiiov	警
jgiiuv	敬
jgiiv	菁
jgiivv	菁
jgio	镜
jgioov	镜
jgiov	倞
jgiovo	倞
jgo	竟
jgoi	景
jgoio	晶
jgoioi	晶
jgoiov	景
jgoo	惊
jgooo	憬
jgoooi	憬
jgooov	惊
jgou	精
jgouv	粳
jgouvi	粳
jgouvv	精
jgov	京
jgova	痉
jgovao	痉
jgoviu	京
jgovo	竞
jgovou	竞
jgovov	麖
jgovu	净
jgovua	竫 竟 净
jgovuv	旌
jgovv	靖
jgovvv	靖
jgu	径
jgua	鲸
jguao	胫
jguaov	猄 獍 鲸 胫
jgui	鼱
jguivv	鼱
jguo	兢
jguouo	兢
jguuao	径
jguv	箐
jguvv	腈
jguvvi	腈
jguvvu	肼
jguvvv	箐
jgv	静
jgvi	更
jgviav	更
jgvo	境
jgvoov	境
jgvv	井
jgvvi	靓
jgvvia	靓
jgvvii	璥
jgvvo	璟
jgvvoi	璟
jgvvu	䴖
jgvvua	静 䴖
jgvvui	井
jh	决
jha	绝
jhaa	𫘝
jhaaav	𫘝
jhaaua	绝
jhai	孓
jhaioo	孓
jhav	㵐
jhavuo	㵐
jhi	拆
jhia	倔
jhiaa	崛
jhiaai	𨟠
jhiaav	崛
jhiai	矍
jhiaia	蠼
jhiaio	矍
jhiavu	倔
jhii	蕨
jhiiv	茝
jhiivi	茝
jhiivu	蕨
jhio	钗
jhioa	傕
jhioao	𫔎 钗
jhioau	傕
jhiov	镢
jhiovu	侪 镢
jhiu	掘
jhiua	抉
jhiuav	掘 抉
jhiui	攫
jhiuia	攫
jhiuuu	拆
jhiuv	撅
jhiuvu	撅
jhiv	柴
jhivvv	柴
jho	觉
jhoa	诀
jhoaa	谲
jhoaao	谲
jhoaav	诀
jhoi	蹶
jhoiv	噱
jhoiva	噱
jhoivu	蹶
jhooia	觉
jhou	差
jhouo	嚼
jhouoo	嚼
jhouu	爝
jhouuo	爝
jhouvi	差
jhov	噘
jhovav	决
jhovo	瘥
jhovou	瘥
jhovuo	噘
jhu	角
jhua	獗
jhuaa	觖
jhuaav	觖
jhuai	玃
jhuaia	玃
jhuaua	角
jhuav	鳜
jhuavu	獗 鳜
jhuo	爵
jhuoav	爵
jhuov	豺
jhuovi	豺
jhuv	脚
jhuvoa	脚
jhv	厥
jhva	虿
jhvaia	虿
jhvu	桷
jhvua	砄
jhvuau	桷
jhvuav	砄
jhvui	劂
jhvuii	劂
jhvuou	厥
jhvv	橛
jhvva	玦
jhvvav	玦
jhvvuo	橛
jhvvv	珏
jhvvvv	珏
jj	出
jja	除
jjaa	绌
jjaaai	绌
jjaai	滁
jjaaii	滁
jjai	䢺
jjaiai	䢺
jjaiia	出
jjaiiv	除
jjav	濋
jjavva	濋
jji	储
jjia	黜
jjiaai	黜
jjiai	蜍
jjiaiv	蜍
jjii	俶
jjiivv	俶
jjio	锄
jjioau	储
jjioia	锄
jjiu	搐
jjiuov	搐
jjiuv	摴
jjiuvo	摴
jjiv	𬺓
jjivvv	𬺓
jjo	初
jjoa	褚
jjoaau	初
jjoauo	褚
jjoi	躇
jjoiii	躇
jjoiv	蹰
jjoivu	蹰
jjoo	怵
jjoou	㤘
jjooua	㤘
jjoov	憷
jjoovo	怵
jjoovv	憷
jjov	畜
jjovia	畜
jju	处
jjua	触
jjuaa	刍
jjuaav	刍
jjuai	雏
jjuaia	触
jjuaio	处 雏
jjuo	矗
jjuouo	矗
jjuov	䝙
jjuovu	䝙
jjuu	斶
jjuuia	斶
jjv	厨
jjvo	柷
jjvoua	柷
jjvu	础
jjvuai	础
jjvuo	楮
jjvuov	楮
jjvuv	杵
jjvuvo	厨
jjvuvu	杵
jjvv	楚
jjvvai	楚
jjvvi	亍
jjvvii	亍
jjvviv	琡
jjvvo	樗
jjvvoa	樗
jjvvu	橱
jjvvuv	橱
jk	即
jka	既
jkaa	级
jkaaa	纪
jkaaav	纪
jkaai	骥
jkaaia	畿
jkaaiv	给 骥
jkaao	继
jkaaou	继
jkaaov	缉
jkaaua	级
jkaav	绩
jkaavu	骑
jkaavv	绩
jkai	际
jkaia	瀱
jkaiai	瀱
jkaio	亟 𬯀
jkaioa	亟
jkaiov	𬯀
jkaivv	际
jkao	济
jkaou	鸡
jkaoua	鸡
jkaovu	济
jkau	激
jkaua	汲
jkauaa	㴔
jkauao	漈 汲
jkaui	洎
jkauia	激 洎
jkauo	嫉
jkauov	嫉
jkauu	妓
jkauuo	妓
jkauv	姬
jkauvi	姬
jkauvo	姞
jkav	己
jkavaa	己
jkavai	即
jkavo	忌
jkavoa	忌
jkavoi	暨
jkavu	屐
jkavua	𬶨
jkavuu	屐
jkavva	既
jkavvo	堲
jki	技
jkia	畸
jkiai	觊
jkiaia	觊
jkiao	嵴
jkiaov	嵴
jkiau	岌
jkiaua	虮 岌
jkiav	羁
jkiavi	羁
jkiavu	罽 畸
jkii	藉
jkiio	蒺
jkiiov	荠 蕺 蒺
jkiiu	蓟
jkiiua	芨 蓟
jkiiuo	芰
jkiiv	䓫
jkiivu	䓫
jkiivv	藉
jkio	集
jkioi	偈
jkioiu	偈
jkiov	𫓯
jkiovi	𫓹
jkiovo	𫓯
jkiovv	集
jkiu	挤
jkiua	伋
jkiuao	伋
jkiuo	伎
jkiuoa	伎
jkiuov	挤
jkiuuo	技
jkiuv	掎
jkiuvu	掎
jkiv	冀
jkiva	乩
jkivaa	乩
jkivia	冀
jkivo	佶
jkivoo	佶
jkivu	𫚖
jkivua	𫚖
jko	记
jkoa	计
jkoaav	记
jkoau	讥
jkoaua	讥
jkoauo	计
jkoav	诘
jkoavo	诘
jkoavv	唧 𫌀
jkoi	跻
jkoia	跽
jkoiav	跽
jkoio	蹐
jkoiov	跻 蹐
jkoo	寄
jkooi	寂
jkooiv	寂
jkoou	悸
jkoouv	悸
jkoovu	寄
jkou	叽
jkouaa	叽
jkov	疾
jkovi	剂
jkovii	戢 剂
jkoviv	齑
jkovo	迹
jkovoa	迹
jkovov	瘠
jkovu	脊
jkovua	麂 鹡
jkovui	齐
jkovuu	脊
jkovuv	疾
jku	几
jkua	及
jkuaa	鲫 几
jkuaav	鱾 鲫
jkuai	系
jkuaiu	系
jkuao	急
jkuaoa	急
jkuaoo	及
jkuaov	鲚
jkuau	饥
jkuaua	𬶭 饥
jkuav	祭
jkuavu	觭
jkuavv	祭
jkuo	戟
jkuoa	赍
jkuoao	赍
jkuova	戟
jkuu	肌
jkuuaa	肌
jkuuv	徛
jkuuvu	徛
jkuv	积
jkuva	季
jkuvai	季
jkuvi	稷
jkuvia	稷
jkuvou	积
jkuvu	笈
jkuvua	穄 笈
jkuvv	籍
jkuvvi	箕
jkuvvu	嵇 犄 稽
jkuvvv	笄 籍
jkv	机
jkva	辑
jkvaov	辑
jkvi	基
jkvii	革
jkviia	革
jkvio	惎
jkvioa	惎
jkviu	期
jkviuo	其
jkviuu	期
jkviv	棘
jkvivi	棘
jkvivo	墼 髻 基
jkvo	吉
jkvoo	霁
jkvooo	吉
jkvoov	霁
jkvou	圾
jkvoua	圾
jkvoui	垍
jkvov	楫
jkvovi	楫
jkvu	极
jkvua	殛
jkvuaa	机
jkvuai	殛
jkvuao	极
jkvui	剞
jkvuii	剞
jkvuu	矶
jkvuua	矶
jkvuv	奇
jkvuvo	奇
jkvv	击
jkvva	𪟝
jkvvau	𪟝
jkvvia	击
jkvvu	玑
jkvvua	玑
jkvvv	枅
jkvvvi	耤
jkvvvu	枅
jl	局
jla	居
jlaa	驹
jlaaua	驹
jlai	沮
jlaiav	沮
jlaiv	澽
jlaiva	澽
jlau	泃
jlauao	泃
jlauv	娵
jlauvi	娵
jlav	剧
jlavao	局
jlavii	剧
jlavu	屦
jlavuo	居
jlavuu	屦
jli	据
jlia	具
jliaa	崌
jliaav	崌
jliai	雎
jliaia	岨
jliaio	瞿 雎
jliau	䴗
jliaua	䴗
jliauo	具
jliav	倨
jliava	岠
jliavu	倨
jliavv	且
jlii	俱
jliia	菹
jliiai	菹
jliiav	俱
jliii	苴
jliiia	苴
jliio	莒
jliioo	莒
jliiov	蒟
jliiu	菊
jliiua	菊
jliiv	苣
jliiva	苣
jlio	锯
jlioa	锔
jlioav	锯 锔
jliov	钜
jliova	钜
jliu	拒
jliuav	据
jliuu	拘
jliuua	掬 拘
jliuva	拒
jliv	遽
jlivi	龃
jlivia	龃
jlivoa	遽
jlo	举
jloa	讵
jloaa	裾
jloaav	裾
jloava	讵
jloi	距
jloia	踞
jloiav	咀 踞
jloiu	踽
jloiui	踽
jloiva	距
jloo	惧
jlooia	惧
jlooo	窭
jlooou	窭
jloovv	举
jlou	炬
jloua	焗
jlouav	焗
jlouva	炬
jlov	疽
jlovia	疽
jlu	句
jlua	狙
jluai	飓
jluaia	狙 飓
jluaoo	句
jluau	𬶋
jluaua	𬶋
jluav	腒
jluavu	腒
jluv	矩
jluvi	犋
jluvia	犋
jluvo	筥
jluvoo	筥
jluvva	秬 矩
jlv	巨
jlva	橘
jlvaoa	橘
jlvav	车
jlvava	巨
jlvavi	车
jlvavu	椐
jlvi	聚
jlvii	醵
jlviiv	醵
jlviu	鞠
jlviua	鞫 鞠
jlviui	聚
jlvo	榉
jlvoi	趄
jlvoia	趄
jlvoou	榉
jlvov	弆
jlvovu	弆
jlvu	枸
jlvuao	枸
jlvui	砠
jlvuia	砠
jlvv	桔
jlvva	琚
jlvvav	柜 琚
jlvvoo	桔
jm	间
jma	建
jmaa	溅
jmaao	缣
jmaaou	缣
jmaaov	溅
jmaav	缄
jmaavu	缄
jmao	艰
jmaoav	艰
jmaoi	涧
jmaoia	涧
jmaou	湔
jmaouv	湔
jmaov	贱
jmaovv	贱
jmau	奸
jmauvv	奸
jmav	渐
jmavai	渐
jmavao	建
jmavv	浅
jmavva	浅
jmi	见
jmia	健
jmiai	睑
jmiaiv	睑
jmiaua	见
jmiavv	健
jmii	坚
jmiii	监
jmiiia	茧 监
jmiiio	鉴
jmiio	菅
jmiioo	菅
jmiiou	蒹
jmiiv	荐
jmiivo	俭 坚
jmiivu	荐
jmio	键
jmioav	键
jmioo	锏
jmiooi	锏
jmiu	件
jmiui	捡
jmiuiv	捡
jmiuo	搛
jmiuou	搛
jmiuv	尖
jmiuva	拣
jmiuvu	尖
jmiuvv	件
jmiv	剑
jmiva	僭
jmivau	僭
jmivii	剑
jmivu	牮
jmivuv	牮
jmo	减
jmoa	肩
jmoao	裥
jmoaoi	裥
jmoaou	谫
jmoauu	肩
jmoav	谏
jmoavi	谏
jmoavv	𬣡
jmoi	践
jmoia	踺
jmoiav	踺
jmoioi	间
jmoiv	趼
jmoivi	暕
jmoivv	践 趼
jmoo	謇
jmooo	蹇
jmoooi	蹇
jmooov	謇
jmou	兼
jmoua	剪
jmouao	翦
jmouau	剪
jmouo	煎
jmouoo	煎
jmouu	鹣
jmouua	鹣
jmouva	兼
jmovvu	减
jmu	简
jmua	饯
jmuai	鲣
jmuaii	鲣
jmuao	鳒
jmuaou	鳒
jmuav	腱
jmuavv	饯 腱
jmuu	舰
jmuuia	舰
jmuv	箭
jmuva	毽
jmuvav	犍 毽
jmuvi	笕
jmuvia	笕
jmuvio	篯
jmuvoi	简
jmuvou	箭
jmuvv	笺
jmuvvv	笺
jmv	检
jmva	楗
jmvavv	楗
jmvi	柬
jmvia	枧
jmviao	柬
jmviau	枧
jmviav	鞬
jmvii	槛
jmviii	鞯
jmviiu	槛
jmviv	戬
jmviva	戬
jmvivo	检
jmvivv	靬
jmvu	歼
jmvuuv	歼
jmvuv	碱
jmvuvu	碱
jmvv	戋
jmvvau	戋
jn	陈
jna	沉
jnaa	𬘭
jnaavv	𬘭
jnaiva	陈
jnao	沈
jnaoau	沉 沈
jni	尘
jnia	瞋
jniauo	瞋
jnii	伧
jniiaa	伧
jniu	抻
jniuia	抻
jniuvo	尘
jniv	龀
jnivua	龀
jno	晨
jnoa	衬
jnoai	谶
jnoaii	谶
jnoav	谌
jnoavi	衬 谌
jnoivu	晨
jnoo	忱
jnoooa	忱
jnoov	宸
jnoovu	宸
jnou	嗔
jnouoi	嗔
jnouv	煁
jnouvi	煁
jnov	疢
jnovou	疢
jnu	称
jnuvua	称
jnv	臣
jnvi	梣
jnviai	梣
jnviav	臣
jnvo	趁
jnvoiu	趁
jnvov	榇
jnvovo	榇
jnvu	辰
jnvua	碜
jnvuao	碜
jnvuvv	辰
jnvv	琛
jnvva	郴
jnvvai	郴
jnvvi	棽
jnvvio	棽
jnvvoa	琛
jp	长
jpa	娼
jpai	淌
jpaiou	淌
jpau	嫦
jpauio	嫦
jpauoi	娼
jpi	常
jpia	畅
jpiaau	畅
jpii	偿
jpiio	菖
jpiioi	菖
jpiiou	倘 偿
jpiiu	苌
jpiiuv	苌
jpio	尝
jpioi	倡
jpioia	常
jpioio	倡
jpioo	裳
jpioov	裳
jpiou	敞
jpiouv	氅 𬬮 敞
jpiovv	尝
jpiu	伥
jpiuva	伥
jpo	唱
jpoa	昶
jpoaoi	昶
jpoi	昌
jpoio	阊
jpoioi	昌 阊
jpoo	怅
jpooi	惝
jpooio	唱 惝
jpoouv	怅
jpu	肠
jpua	猖
jpuai	鲿
jpuaio	鲿
jpuao	鲳
jpuaoi	猖 鲳
jpuauu	肠
jpuo	鬯
jpuoua	鬯
jpuu	徜
jpuuio	徜
jpuvao	长
jpv	场
jpvoau	场
jpvu	厂
jpvuu	厂
jpvv	玚
jpvvau	玚
jq	久
jqa	酒
jqaa	纠
jqaaai	纠
jqau	氿
jqauaa	氿
jqavia	酒
jqi	旧
jqia	㠇
jqiaov	㠇
jqio	僦
jqioii	旧
jqiovo	僦
jqiu	揪
jqiuuv	揪
jqiv	韭
jqivvv	韭
jqo	究
jqoi	阄
jqoio	蹴
jqoiov	蹴
jqoiua	阄
jqooua	究
jqou	啾
jqouvi	啾
jqov	疚
jqovu	鹫
jqovua	疚 鹫
jqovvu	就
jqu	九
jqua	灸
jquaa	九
jquao	咎
jquaoo	久 咎
jquaou	灸
jquau	鸠
jquaua	鸠
jqui	舅
jquiia	舅
jquiv	臼
jquiva	臼
jqv	救
jqvi	鬏
jqviuv	救 鬏
jqvo	赳
jqvoai	赳
jqvu	厩
jqvuav	厩
jqvui	桕
jqvuiv	桕
jqvv	玖
jqvvu	柩
jqvvua	玖 柩
jr	成
jra	承
jraa	澄
jraai	骋
jraaia	骋
jraaou	澄
jrai	丞
jraia	澂
jraiai	澂
jraiau	丞
jraivv	承
jri	撑
jria	瞠
jriaa	蛏
jriaao	蛏
jriaio	瞠
jrio	铖
jrioi	铛
jrioio	铛
jriov	牚
jriova	牚
jriovu	铖
jriu	抢
jriuia	抢
jriuio	撑
jriuo	偁
jriuoo	偁
jro	呈
jroa	诚
jroao	裎
jroaov	裎
jroavu	诚
jroi	晟
jroivu	晟
jroo	宬
jrooa	憕
jrooao	憕
jroou	噌
jrooui	噌
jroovu	宬
jrov	逞
jrovoa	逞
jrovv	庱
jrovvi	呈
jrovvo	庱
jru	称
jruo	塍
jruovo	塍
jruu	惩
jruuoa	惩
jruv	程
jruvi	乘
jruviv	乘
jruvov	程
jruvua	称
jruvv	秤
jruvvo	秤
jrv	城
jrva	橙
jrvao	柽
jrvaou	橙
jrvaov	柽
jrvi	酲
jrvio	樘
jrviou	樘
jrviov	酲
jrvo	埕
jrvoi	赪
jrvoiv	赪
jrvoov	埕
jrvovu	城
jrvu	盛
jrvuaa	成
jrvuia	盛
jrvuv	枨
jrvuva	枨
jrvv	琤
jrvvo	珵
jrvvov	珵
jrvvua	琤
jrvvv	珹
jrvvvu	珹
js	加
jsa	架
jsaa	泇
jsaauo	泇
jsau	驾
jsauaa	驾
jsauo	嫁
jsauoa	迦
jsauoo	加 嫁
jsauov	袈
jsauvv	架
jsav	浃
jsava	叚
jsavav	叚
jsavo	浃
jsavou	浃
jsi	假
jsia	甲
jsiai	岬
jsiaia	岬
jsiau	伽
jsiauo	伽
jsiav	蛱
jsiavi	假
jsiavo	蛱
jsiavv	甲
jsii	价
jsiia	茄
jsiiau	茄
jsiiav	葭
jsiiui	价
jsiiv	荚
jsiivo	荚
jsio	钾
jsioia	钾
jsioo	镓
jsiooo	镓
jsiov	铗
jsiovo	铗
jsiu	挟
jsiuv	拮
jsiuvo	拮 挟
jsiv	佳
jsivov	佳
jso	家
jsoa	咖
jsoai	袷
jsoaiv	袷
jsoauo	咖
jsoi	跏
jsoiau	跏
jsoo	斝
jsoooo	斝
jsoovu	家
jsov	痂
jsova	瘕
jsovau	痂
jsovav	瘕
jsu	胛
jsuiav	胛
jsuo	嘏
jsuoav	嘏
jsuv	稼
jsuva	笳
jsuvau	笳
jsuvoo	稼
jsv	夹
jsva	枷
jsvauo	枷
jsvi	贾
jsviao	贾
jsvo	嘉
jsvoa	郏
jsvoai	郏
jsvoau	嘉
jsvouv	夹
jsvov	颊
jsvovu	颉 颊
jsvu	戛
jsvuva	戛
jsvv	珈
jsvvau	珈
jsvvi	槚
jsvvia	槚
jsvvo	恝
jsvvoa	恝
jsvvou	𬂩
jt	卷
jta	绢
jtaaou	绢
jtao	涓
jtaouu	涓
jtau	娟
jtauou	娟
jti	捐
jtia	圈
jtiaou	圈
jtio	倦
jtioa	隽
jtioau	隽
jtioi	镌
jtioio	镌
jtioo	锩
jtioou	𫓶 锩
jtiouv	倦
jtiuou	捐
jto	眷
jtou	鹃
jtouaa	卷
jtoui	蠲
jtouia	眷 蠲
jtouo	焆
jtouou	焆
jtouua	鹃
jtouv	桊
jtouvv	桊
jtu	狷
jtuaou	狷
jtv	鄄
jtviai	鄄
jw	均
jwa	纯
jwaa	骏
jwaaao	骏
jwaao	浚
jwaaou	浚
jwaava	纯
jwao	淳
jwaovo	淳
jwav	君
jwava	郡
jwavai	郡
jwavoo	君
jwavv	𫖳
jwavvu	𫖳
jwi	俊
jwia	峻
jwiaa	畯
jwiaao	峻 畯
jwiaou	俊
jwiav	蝽
jwiavv	蝽
jwii	菌
jwiia	莼
jwiiaa	莼
jwiiav	莙
jwiii	葰
jwiiia	菌 葰
jwio	钧
jwioa	隽
jwioau	隽
jwioo	𬭚
jwioov	𬭚
jwioua	钧
jwiu	捃
jwiuav	捃
jwo	军
jwoa	皲
jwoaau	皲
jwoava	军
jwoi	晙
jwoiao	晙
jwou	焌
jwouao	焌
jwov	竣
jwovao	竣
jwovu	鹑
jwovua	鹑
jwovuv	麇
jwu	龟
jwua	鲪
jwuaav	鲪
jwuaia	龟
jwuav	䲠
jwuavv	䲠
jwui	䐃
jwuiau	䐃
jwuu	朐
jwuuao	朐
jwuv	筠
jwuva	肫
jwuvai	肫
jwuvv	䏝
jwuvva	䏝
jwuvvo	筠
jwv	春
jwvi	醇
jwviov	醇
jwvo	堾
jwvoua	均
jwvovv	堾
jwvu	唇
jwvuoo	唇
jwvv	蠢
jwvva	珺
jwvvav	珺
jwvvia	蠢
jwvvoi	春
jwvvv	椿
jwvvvv	瑃 椿
jx	将
jxa	江
jxaa	缰
jxaau	绛
jxaaua	绛
jxaavi	缰
jxai	降
jxaiua	降
jxau	洚
jxauao	洚
jxav	疆
jxaviv	江
jxavo	强
jxavoi	强
jxavov	弶
jxavu	犟
jxavuv	犟
jxavvi	疆
jxi	蒋
jxia	虹
jxiavi	虹
jxii	茳
jxiiav	茳
jxiiov	蒋
jxiv	僵
jxivia	僵
jxo	讲
jxoavv	讲
jxou	姜
jxoua	糨
jxouau	姜
jxouav	糨
jxov	奖
jxova	浆
jxovaa	浆
jxovua	将
jxovv	桨
jxovvi	酱
jxovvu	奖
jxovvv	桨
jxu	鳉
jxua	膙
jxuaov	鳉
jxuava	膙
jxv	匠
jxvo	豇
jxvovi	豇
jxvu	礓
jxvuuv	匠
jxvuvi	礓
jxvv	耩
jxvvvv	耩
jya	泂
jyaa	䌹
jyaai	𬳶
jyaaia	䌹 𬳶
jyaiao	泂
jyi	迥
jyia	冏
jyiaoa	迥
jyiauo	冏
jyo	窘
jyoa	扃
jyoaia	扃
jyoi	炅
jyoiou	炅
jyooav	窘
jyou	炯
jyouia	炯
jyu	颎
jyuavu	颎
jyui	䐃
jyuiau	䐃
jyv	坰
jyvoia	坰
jz	超
jza	潮
jzaa	巢
jzaai	绰
jzaaia	巢
jzaaii	剿
jzaaiv	绰
jzauoo	潮
jzav	弨
jzavau	弨
jzi	抄
jzio	钞
jzioiu	钞
jziuiu	抄
jzo	炒
jzoi	吵
jzoiu	晁
jzoiuo	吵 晁
jzoo	怊
jzooau	怊
jzou	嘲
jzoui	焯
jzouiu	炒
jzouiv	焯
jzouoo	嘲
jzu	朝
jzuouu	朝
jzv	耖
jzvoau	超
jzvviu	耖
k	可
kb	亏
kba	溃
kbaa	骙
kbaaao	骙
kbai	隗
kbaiav	溃
kbaiui	隗
kbao	戣
kbaova	戣
kbi	葵
kbia	睽
kbiaao	睽
kbiai	岿
kbiaiu	岿
kbiav	蝰
kbiavu	蝰
kbii	蒉
kbiiao	葵
kbiiia	蒉
kbiu	傀
kbiua	揆
kbiuao	揆
kbiuia	傀
kbo	愧
kboi	喟
kboia	暌
kboiao	暌
kboiav	喟
kboiv	跬
kboivo	跬
kboo	窥
kbooi	愦
kbooia	悝 愦
kbooui	愧
kboovv	窥
kbou	夔
kbouua	夔
kbouv	煃
kbouvu	煃
kbov	喹
kbovuo	喹
kbu	魁
kbua	馈
kbuaia	馈
kbuao	馗
kbuaou	馗
kbuioo	魁
kbuo	𫠆
kbuovu	𫠆
kbuv	篑
kbuvia	篑
kbv	奎
kbvi	匮
kbviav	匮
kbvii	聩
kbviia	聩
kbvo	逵
kbvooa	逵
kbvu	盔
kbvui	櫆
kbvuia	盔 櫆
kbvuvo	奎
kbvvaa	亏
kd	口
kda	𫸩
kdavvu	𫸩
kdi	扣
kdia	眍
kdiavu	眍
kdii	蔻
kdiia	芤
kdiiai	芤
kdiioo	蔻
kdiu	抠
kdiuoo	扣
kdiuvu	抠
kdo	叩
kdoaii	叩
kdoo	寇 口
kdoovv	寇
kdu	筘
kduviu	筘
ke	克
kea	渴
keaa	缂
keaai	骒
keaaia	骒
keaavi	缂
keai	牁
keaivo	牁
keaoiu	渴
keav	溘
keavoa	溘
kei	颗
keia	瞌
keiai	髁
keiaia	髁
keiau	蝌
keiauv	蝌
keiav	岢
keiavo	瞌 岢
keiavu	颗
keii	苛
keiivo	苛
keio	锞
keioi	铪
keioia	锞
keioiv	铪
keo	客
keoa	课
keoaia	课
keoo	咳
keooi	窠
keooia	窠
keooo	喀
keoooa	喀
keoou	恪
keooua	客 恪
keoova	咳
keou	炣
keouvo	炣
keov	刻
keovii	刻
keovo	嗑
keovoa	嗑
keovoi	呵
keovv	颏
keovvo	疴
keovvu	颏
keu	科
keuoou	克
keuv	稞
keuvia	稞
keuvoo	科
keuvu	氪
keuvuo	氪
kev	壳
keva	轲
kevavo	轲
kevi	棵
keviav	棵
keviv	匼
kevivo	匼
kevo	坷
kevoii	可
kevoua	壳
kevovo	坷
kevu	磕
kevuvo	磕
kevv	柯
kevvoi	柯
kevvv	珂
kevvvo	珂
kf	看
kfi	侃
kfia	瞰
kfiaav	瞰
kfiav	崁
kfiavi	嵁 嵌
kfiavo	崁
kfii	莰
kfiivo	莰
kfioui	侃
kfiuia	看
kfiv	龛
kfivvu	龛
kfo	阚
kfoiav	阚
kfu	衎
kfuuvv	衎
kfv	堪
kfvi	勘
kfviau	勘
kfvii	槛
kfviiu	槛
kfviv	戡
kfviva	戡
kfvo	坎
kfvoua	坎
kfvov	墈
kfvovi	堪 墈
kfvu	砍
kfvuua	砍
kfvuv	磡
kfvuvi	磡
kfvv	刊
kfvvii	刊
kg	快
kga	浍
kgaivv	浍
kgi	会
kgii	侩
kgiii	蒯
kgiiia	蒉
kgiiii	蒯
kgiivv	侩
kgiu	㧟
kgiuav	㧟
kgiv	郐
kgivai	郐
kgivva	会
kgo	哙
kgoivv	哙
kgooav	快
kgu	筷
kgua	狯
kguai	鲙
kguaiv	狯 鲙
kgui	脍
kguivv	脍
kguvoo	筷
kgv	块
kgvoav	块
kh	开
khi	凯
khia	剀
khiaii	剀
khiaua	凯
khii	蒈
khiiva	蒈
khio	铠
khioia	铠
khioo	锎
khiooi	锎
khiov	锴
khiova	锴
khiu	揩
khiuva	揩
kho	慨
khoi	闿
khoiia	闿
khoo	忾
khooav	慨
khooi	恺
khooia	恺
khoouv	忾
khou	炌
khouiu	炌
khv	楷
khvo	垲
khvoia	垲
khvvau	楷
khvvui	开
kj	哭
kja	绔
kjaavu	绔
kji	苦
kjia	骷
kjiai	圐
kjiaia	圐
kjiauo	骷
kjiiuo	苦
kjo	库
kjoa	裤
kjoaov	裤
kjoo	窟
kjooav	窟
kjoou	喾
kjoouv	喾
kjoovu	哭
kjovva	库
kjv	酷
kjviuv	酷
kjvu	枯
kjvui	刳
kjvuii	刳
kjvuoo	枯
kjvuu	矻
kjvuuv	矻
kl	扩
kli	括
klia	蛞
kliauv	蛞
kliuov	扩
kliuuv	括
klo	阔
kloiau	阔
klov	廓
klovov	廓
klu	适
kluvoa	适
klv	栝
klvuvi	栝
km	况
kma	纩
kmaaov	纩
kmao	贶
kmaoou	贶
kmav	洭
kmavvv	洭
kmi	眶
kmiavv	眶
kmo	旷
kmoa	诳
kmoaua	诳
kmoav	诓
kmoavv	诓
kmoiov	旷
kmov	邝
kmovai	邝
kmovou	况
kmovv	哐
kmovvv	哐
kmu	狂
kmua	𫛭
kmuaua	𫛭
kmuavv	狂
kmuv	筐
kmuvvv	筐
kmv	框
kmvo	圹
kmvoov	圹
kmvu	矿
kmvuov	矿
kmvuu	夼
kmvuui	夼
kmvv	匡
kmvvvi	匡
kmvvvv	框
kn	肯
kna	恳
knav	垦
knavoa	恳
knavvo	垦
kni	龈
knivav	龈
knivuu	肯
kno	啃
knoa	裉
knoaav	裉
knoivi	啃
knv	硍
knvuav	硍
kp	抗
kpi	扛
kpio	伉
kpioo	钪
kpioov	钪
kpiovu	伉
kpiuov	抗
kpiuvi	扛
kpo	康
kpoi	闶
kpoiov	闶
kpoo	慷
kpooov	慷
kpou	糠
kpouo	炕
kpouov	糠 炕
kpov	亢
kpovav	康
kpovua	亢
kpu	𩾌
kpuaov	𩾌
kpv	𡐓
kpvoov	𡐓
kq	夸
kqa	姱
kqauvu	姱
kqi	挎
kqiuvu	挎
kqiv	侉
kqivuo	侉
kqo	跨
kqoivu	跨
kqu	胯
kquvuo	胯
kqv	垮
kqvovu	垮
kqvuvv	夸
kr	坑
kri	铿
krioii	铿
kro	吭
kroovu	吭
krv	硁
krvoov	坑
krvuao	硁
ks	卡
ksivvi	卡
kso	咖
ksoauo	咖
ksoi	咔
ksoivv	咔
ksoo	喀
ksoooa	喀
ksou	咯
ksouao	咯
ksu	胩
ksuivv	胩
kt	宽
kti	髋
ktiaoo	髋
ktooii	宽
ktv	款
ktvoua	款
kw	困
kwa	婫
kwauoi	婫
kwi	捆
kwiavv	困
kwio	锟
kwiooi	锟
kwiuia	捆
kwo	昆
kwoa	裈
kwoaoa	裈
kwoi	阃
kwoiia	阃
kwoiu	鹍
kwoiua	鹍
kwoiva	昆
kwoo	悃
kwooia	悃
kwou	焜
kwouoi	焜
kwov	堃
kwovvo	堃
kwu	鲲
kwuaoi	鲲
kwuo	剋
kwuoii	剋
kwv	坤
kwvi	髡
kwvio	醌
kwvioi	醌
kwvivu	髡
kwvo	壸
kwvoia	坤
kwvovi	壸
kwvv	琨
kwvvoi	琨
kx	况
kxa	纩
kxaaov	纩
kxao	贶
kxaoou	贶
kxav	洭
kxavvv	洭
kxi	眶
kxiavv	眶
kxo	旷
kxoa	诳
kxoaua	诳
kxoav	诓
kxoavv	诓
kxoiov	旷
kxov	邝
kxovai	邝
kxovou	况
kxovv	哐
kxovvv	哐
kxu	狂
kxua	𫛭
kxuaua	𫛭
kxuavv	狂
kxuv	筐
kxuvvv	筐
kxv	框
kxvo	圹
kxvoov	圹
kxvu	矿
kxvuov	矿
kxvuu	夼
kxvuui	夼
kxvv	匡
kxvvvi	匡
kxvvvv	框
ky	空
kya	孔
kyaiaa	孔
kyi	控
kyia	崆
kyiaoo	崆
kyio	倥
kyiooa	倥
kyiuoo	控
kyoovi	空
kyu	箜
kyuvoo	箜
kyv	恐
kyvioa	恐
kyvo	埪
kyvooo	埪
kyvu	硿
kyvuoo	硿
kz	靠
kza	尻
kzau	洘
kzauov	洘
kzavua	尻
kzi	拷
kzio	铐
kziouo	铐
kziuuo	拷
kzo	烤
kzou	㸆
kzouuo	烤
kzouuv	㸆
kzu	考
kzuova	考
kzuv	犒
kzuviv	靠
kzuvov	犒
kzv	栲
kzvuov	栲
l	了
lb	林
lba	淋
lbaa	𬘭
lbaao	𬴊
lbaaou	𬴊
lbaavv	𬘭
lbao	潾
lbaouv	潾
lbavvv	淋
lbi	临
lbia	嶙
lbiao	瞵
lbiaou	嶙 瞵
lbii	蔺
lbiioi	蔺
lbiiuv	临
lbio	邻
lbioai	邻
lbioo	𬭸
lbioou	𬭸
lbiu	拎
lbiua	赁
lbiuao	赁
lbiuio	拎
lbo	麟
lboi	躏
lboiii	躏
lboo	懔
lbooov	懔
lbou	粼
lboua	翷
lbouaa	粼
lbouao	翷
lbouo	遴
lbouoa	遴
lbov	凛
lbovo	吝
lbovoo	吝
lbovou	麟
lbovov	廪 凛
lbovv	啉
lbovvv	啉
lbu	鳞
lbuaou	鳞
lbuo	膦
lbuouv	膦
lbuv	箖
lbuvvv	箖
lbv	琳
lbva	辚
lbvaou	辚
lbvo	霖
lbvov	檩
lbvovi	檩
lbvovv	霖
lbvu	磷
lbvuou	磷
lbvv	璘
lbvvou	璘
lbvvv	林
lbvvvv	琳
lc	聊
lca	辽
lcaa	缭
lcaao	漻
lcaaov	漻
lcaavu	缭
lcaii	了
lcaioa	辽
lcau	嫽
lcauvu	嫽
lcav	潦
lcavuo	潦
lci	僚
lcia	瞭
lciaa	髎
lciaao	髎
lciavu	瞭
lcii	蓼
lciiao	蓼
lcio	镣
lcioa	钌
lcioai	钌
lciovu	镣
lciu	撩
lciui	撂
lciuia	撂
lciuvu	撩
lcivuo	僚
lco	料
lcoi	蹽
lcoivu	蹽
lcoo	寥
lcooao	寥
lcoov	寮
lcoovu	憭 寮
lcou	燎
lcouoo	料
lcouvu	燎
lcov	疗
lcova	廖
lcovai	疗
lcovao	廖
lcovu	嘹
lcovuo	嘹
lcu	獠
lcuavu	獠
lcuv	簝
lcuvvu	簝
lcv	尥
lcviua	聊
lcvo	𪤗
lcvoao	𪤗
lcvu	鹩
lcvuua	尥 鹩
lcvv	橑
lcvvuo	橑
ld	楼
lda	漏
ldaavu	漏
ldai	陋
ldaivi	陋
ldao	溇
ldaouv	溇
ldav	洌
ldavua	洌
ldi	搂
ldia	髅
ldiao	蝼
ldiaou	嵝 䁖 髅 蝼
ldii	蒌
ldiiou	蒌
ldio	镂
ldioou	镂
ldiou	偻
ldiouv	偻
ldiu	劣
ldiuau	劣
ldiuo	捩
ldiuoa	捩
ldiuou	搂
ldo	咧
ldoi	躐
ldoiaa	躐
ldoo	喽
ldoouv	喽
ldou	娄
ldouau	娄
ldov	冽
ldovo	瘘
ldovou	瘘
ldovua	咧
ldovvu	冽
ldu	猎
ldua	𫚭
lduaaa	𫚭
lduavi	猎
lduo	𦝼
lduouv	𦝼
lduu	脟
lduuoo	脟
lduv	篓
lduvou	篓
ldv	列
ldvi	鬣
ldviaa	鬣
ldvo	露
ldvoi	剅
ldvoii	剅
ldvoo	𪣻
ldvooi	露
ldvoou	𪣻
ldvou	埒
ldvouo	埒
ldvouv	楼
ldvov	趔
ldvovu	趔
ldvu	裂
ldvuii	列
ldvuo	烈
ldvuoo	烈
ldvuov	裂
ldvuu	䴕
ldvuua	䴕
ldvv	耧
ldvvou	耧
le	乐
lea	泐
leaaia	泐
leaii	了
lei	仂
leiauu	仂
leo	嘞
leoa	叻
leoauu	叻
leovii	嘞
leu	肋
leua	饹
leuaiu	乐
leuaua	饹
leuauu	肋
leuav	鳓
leuavi	鳓
leuv	簕
leuvvi	簕
lev	勒
leviau	勒
lf	兰
lfa	滥
lfaa	缆
lfaaii	缆
lfaiiu	滥
lfao	澜
lfaoia	澜
lfav	漤
lfavva	漤
lfi	蓝
lfia	岚
lfiau	罱
lfiaua	岚
lfiauo	罱
lfii	览
lfiiia	览
lfiiii	蓝
lfio	镧
lfiooi	镧
lfiu	拦
lfiui	揽
lfiuii	揽
lfiuou	拦
lfo	烂
lfoa	褴
lfoaii	褴
lfoao	谰
lfoaoi	襕 谰
lfoi	阑
lfoivi	阑
lfoo	懒
lfoovi	懒
lfouou	烂
lfouvv	兰
lfov	斓
lfovoi	斓
lfovv	啉
lfovvv	啉
lfu	篮
lfuvii	篮
lfv	栏
lfvi	榄
lfviiu	榄
lfvouv	栏
lfvu	𬒗
lfvuii	𬒗
lfvv	婪
lfvvau	婪
lg	领
lga	灵
lgaa	绫
lgaavo	绫
lgai	陵
lgaio	泠
lgaioa	泠
lgaivo	陵
lgau	姈
lgauio	姈
lgav	澪
lgavoa	澪
lgavou	灵
lgi	令
lgia	岭
lgiai	蛉
lgiaio	囹 岭 蛉
lgiav	崚
lgiavo	崚
lgii	菱
lgiii	苓
lgiiio	苓
lgiio	伶
lgiioa	伶
lgiivo	菱
lgio	铃
lgioa	翎
lgioao	令 翎
lgioio	铃
lgiou	鸰
lgioua	鸰
lgiov	瓴
lgiova	瓴
lgiovu	领
lgiv	龄
lgivio	龄
lgo	另
lgoa	祾
lgoauu	另
lgoavo	祾
lgoi	呤
lgoii	昤
lgoiio	昤
lgoioa	呤
lgoov	㥄
lgoovo	㥄
lgou	羚
lgouio	羚
lgov	凌
lgovvo	凌
lgu	鲮
lguavo	鲮
lguu	舲
lguuio	舲
lgv	零
lgva	棂
lgvavv	棂
lgvi	聆
lgviio	聆
lgvio	柃
lgvioa	柃
lgvo	酃
lgvoai	酃
lgvoi	坽
lgvoio	零 坽
lgvv	玲
lgvvio	玲
lgvvo	棱
lgvvou	棱
lh	来
lha	濑
lhav	涞
lhavia	濑
lhavou	涞
lhi	略
lhia	睐
lhiau	圙
lhiaua	略
lhiauo	圙
lhiav	崃
lhiavo	睐 崃
lhiavu	𫵷
lhii	莱
lhiivo	莱
lhio	锊
lhiouo	锊
lhiov	铼
lhiovo	铼
lhiu	掠
lhiuov	掠
lhiv	俫
lhivou	俫
lho	癞
lhovvi	癞
lhu	籁
lhuu	徕
lhuuvo	徕
lhuvvi	籁
lhv	赖
lhviua	赖
lhvo	赉
lhvoao	赉
lhvouv	来
lhvv	梾
lhvvou	梾
lhvvv	䂮
lhvvvu	䂮
lj	路
lja	陆
ljaa	绿
ljaaa	𫘧
ljaaav	绿 𫘧
ljaav	渌
ljaavv	渌
ljai	泸
ljaiva	泸
ljaivv	陆
ljao	赂
ljaoa	勠
ljaoau	勠
ljaoi	潞
ljaoiv	潞
ljaoua	赂
ljaov	戮
ljaova	戮
ljaovu	漉
ljau	澛
ljauai	澛
ljav	录
ljavaa	录
ljavo	逯
ljavoa	逯
lji	卢
ljia	僇
ljiaov	僇
ljii	芦
ljiia	蓼
ljiiao	蓼
ljiiav	菉
ljiio	蕗
ljiioa	芦
ljiioi	蕗
ljio	镥
ljioi	𬬻
ljioiv	𬬻
ljioua	镥
ljiu	撸
ljiui	掳
ljiuiv	掳
ljiuua	撸
ljiv	虏
ljivau	虏
ljivav	卢
ljivi	卤
ljivia	卤
ljivu	鸬
ljivua	鸬
ljivv	颅
ljivvu	颅
ljo	炉
ljoa	禄
ljoaav	禄
ljoi	鹭
ljoiua	路 鹭
ljou	噜
ljouai	噜
ljouoa	炉
ljov	鹿
ljovo	庐
ljovoa	庐
ljovu	六
ljovuo	六
ljovva	鹿
lju	鲁
ljua	鲈
ljuaiv	鲈
ljuaoi	鲁
ljui	胪
ljuiva	胪
ljuu	舻
ljuua	甪
ljuuav	甪
ljuuiv	舻
ljuv	氇
ljuva	箓
ljuvav	箓
ljuvo	簏
ljuvov	簏
ljuvua	氇
ljuvv	稑
ljuvvo	稑
ljv	露
ljva	辘
ljvai	轳
ljvaiv	轳
ljvaov	辘
ljvau	辂
ljvaua	辂
ljvi	栌
ljviva	栌
ljvo	垆
ljvoiv	垆
ljvooi	露
ljvu	碌
ljvua	橹
ljvuai	橹
ljvuav	碌
ljvv	麓
ljvva	琭
ljvvav	琭
ljvvo	璐
ljvvoi	璐
ljvvov	麓
lk	里
lka	力
lkaa	蠡
lkaaia	蠡
lkaao	缡
lkaaov	缡
lkaav	骊
lkaavi	骊
lkai	澧
lkaia	浬
lkaiav	澧 浬
lkao	漓
lkaovu	漓
lkau	娌
lkauia	娌
lkauu	力
lkauv	浰
lkauvi	浰
lkav	隶
lkavi	溧
lkavia	溧
lkavu	沥
lkavua	沥
lkavvi	隶
lki	例
lkia	罹
lkiao	詈
lkiaoo	罹
lkiaov	詈
lkiau	蜊
lkiauv	蜊
lkiav	蛎
lkiavu	峛 𫵷 蛎
lkiavv	里
lkii	莉
lkiia	荔
lkiiau	荔
lkiiav	俚
lkiii	莅
lkiiio	莅
lkiio	蓠
lkiiov	蓠
lkiiu	藜
lkiiuv	莉 藜
lkiiv	苈
lkiivu	苈
lkio	锂
lkioia	锂
lkiu	俐
lkiuvi	俐
lkiv	俪
lkivi	傈
lkivia	俪 傈
lkivua	例
lko	立
lkoa	礼
lkoaaa	礼
lkoav	戾
lkoavu	戾
lkoi	哩
lkoiav	哩
lkoiu	跞
lkoiua	跞
lkoo	唳
lkooav	唳
lkooi	悝
lkooia	悝
lkou	粒
lkouov	粒
lkouv	粝
lkouvu	粝
lkov	离
lkovia	离
lkovou	立
lkovu	痢
lkovua	呖
lkovui	喱
lkovuv	痢
lkovv	疠
lkovva	疠
lkovvi	凓
lkovvu	疬
lku	利
lkua	狸
lkuai	鲤
lkuaia	鳢 狸 鲤
lkuau	猁
lkuauv	猁
lkuav	鲡
lkuavi	鲡
lkuv	梨
lkuvi	黎
lkuvia	黧 黎
lkuvii	利
lkuvo	篱
lkuvov	笠 篱
lkuvu	犁
lkuvuv	犁
lkuvv	篥
lkuvvi	篥
lkuvvv	梨
lkv	理
lkva	李
lkvaiv	李
lkvau	轹
lkvaua	轹
lkvauu	朸
lkvi	丽
lkvia	吏
lkviai	郦
lkviao	丽
lkviav	吏
lkvii	醴
lkviia	醴
lkvio	逦
lkvioa	逦
lkviov	醨
lkviu	鹂
lkviua	鹂
lkviv	栗
lkvivv	栗
lkvo	雳
lkvoi	鬲
lkvoia	鬲
lkvov	坜
lkvovu	雳 坜
lkvu	历
lkvua	励
lkvuai	栎
lkvuau	历 励
lkvui	厘
lkvuia	厘
lkvuo	砬
lkvuov	砬
lkvuu	砾
lkvuua	砾
lkvuv	厉
lkvuva	厉
lkvuvi	㰀
lkvuvu	砺
lkvv	璃
lkvva	珕
lkvvau	嫠 珕
lkvvi	釐
lkvvia	理 釐
lkvvov	璃
lkvvu	枥
lkvvua	𬍛 枥
ll	落
lla	绿
llaa	驴
llaaav	绿
llaai	骡
llaaia	骡
llaao	缕
llaaoa	驴
llaaou	缕
llaau	络
llaaua	骆 络
llai	滤
llaia	漯
llaiav	漯
llaiva	滤
llau	洛
llaua	泺
llauai	泺
llauao	洛
llav	屡
llavou	屡
llavu	履
llavuu	履
lli	罗
llia	逻
lliai	螺
lliaia	螺
lliaoa	逻
lliaua	罗
llii	萝
lliia	倮
lliiau	落
lliiav	菉 倮
lliiia	萝
lliiu	荦
lliiuu	葎 蓏
lliiuv	荦
llio	侣
llioi	锣
llioia	锣
llioo	铝
lliooo	侣 铝
lliou	偻
lliouv	偻
lliu	捋
lliui	摞
lliuia	摞
lliuuo	捋
lliv	虑
llivoa	虑
llo	率
lloa	裸
lloaia	裸
lloao	褛
lloaou	褛
lloi	啰
lloiai	啰
lloio	闾
lloioo	闾
lloiu	跞
lloiua	跞
lloo	吕
llooo	吕
llou	咯
llouao	咯
llouu	烙
llouua	烙
llov	旅
llovaa	率
llovi	蠃
llovia	瘰 蠃
llovu	膂
llovuu	膂
llovuv	旅
llu	律
llua	猡
lluai	雒
lluaia	猡
lluaio	雒
lluo	脶
lluoia	脶
lluou	𦝼
lluouv	𦝼
lluuav	律
lluv	箩
lluva	氯
lluvav	氯
lluvia	箩
lluvo	稆
lluvoo	稆
llv	榈
llvi	椤
llviai	椤
llvo	垏
llvoav	垏
llvoia	榈
llvoo	梠
llvooo	梠
llvu	硌
llvuua	硌
llvv	珞
llvvua	珞
lm	连
lma	练
lmaava	练
lmai	潋
lmaivo	潋
lmao	濂
lmaovu	濂
lmau	浰
lmauvi	浰
lmav	涟
lmavav	涟
lmi	莲
lmia	蠊
lmiaov	蠊
lmii	莶
lmiii	蔹
lmiiiv	莶 蔹
lmiiva	莲
lmio	链
lmioo	镰
lmioov	镰
lmiova	链
lmiv	敛
lmivuv	敛
lmo	恋
lmoa	裢
lmoai	裣
lmoaiv	裣
lmoava	裢
lmoo	怜
lmooi	帘
lmooia	帘
lmooio	怜
lmou	炼
lmouva	炼
lmov	廉
lmovoa	恋
lmovou	廉
lmu	脸
lmua	鲢
lmuav	𬶠
lmuava	鲢
lmuavi	𬶠
lmuivo	脸
lmv	联
lmvaoa	连
lmviou	联
lmvu	殓
lmvuiv	殓
lmvuo	磏
lmvuou	磏
lmvuv	奁
lmvuvu	奁
lmvv	琏
lmvva	梿
lmvvav	梿
lmvvi	楝
lmvvia	楝
lmvvv	瑓
lmvvva	琏
lmvvvi	瑓
lp	浪
lpaoav	浪
lpi	螂
lpia	崀
lpiaoa	螂 崀
lpii	莨
lpiia	蒗
lpiiao	蒗
lpiio	蓢
lpiioa	莨 蓢
lpio	锒
lpiooa	锒
lpo	朗
lpoa	郎
lpoaai	郎
lpoauu	朗
lpoav	塱
lpoavo	塱
lpoavv	㮾
lpoi	阆
lpoio	㫰
lpoioa	阆 㫰
lpoo	啷
lpooav	啷
lpou	烺
lpouoa	烺
lpov	廊
lpovoa	廊
lpu	狼
lpuaoa	狼
lpuv	稂
lpuvo	筤
lpuvoa	稂 筤
lpv	琅
lpvo	榔
lpvoa	桹
lpvoav	榔 桹
lpvoo	埌
lpvooa	埌
lpvvoa	琅
lq	刘
lqa	流
lqaa	绺
lqaau	骝
lqaaua	绺 骝
lqai	陆
lqaivv	陆
lqao	浏
lqaoi	鎏
lqaoio	鎏
lqaou	鹨
lqaoua	鹨
lqaov	瑬
lqaova	流
lqaovu	浏
lqaovv	瑬
lqau	溜
lqauao	溜
lqi	镏
lqia	疁
lqiaao	疁
lqiau	罶
lqiaua	罶
lqio	锍
lqioa	镠
lqioao	镠
lqioov	锍
lqioua	镏
lqo	六
lqou	熘
lqouua	熘
lqov	瘤
lqovii	刘
lqovu	旒
lqovua	瘤
lqovuo	六
lqovuv	旒
lqu	留
lqua	遛
lquaia	留
lquaoa	遛
lquau	馏
lquaua	飗 鹠 馏
lqv	柳
lqvu	硫
lqvua	榴
lqvuao	榴
lqvuau	柳
lqvuav	碌
lqvuov	硫
lqvv	琉
lqvvov	琉
lqvvu	珋
lqvvua	珋
lr	冷
lri	崚
lriavo	崚
lro	愣
lrooia	愣
lrovio	冷
lrv	棱
lrvi	楞
lrviai	楞
lrvo	塄
lrvoia	塄
lrvov	堎
lrvovo	堎
lrvvou	棱
ls	拉
lsa	邋
lsaaoa	邋
lsi	俩
lsia	蜡
lsiav	蝲
lsiavi	蜡 蝲
lsii	落
lsiiau	落
lsio	镴
lsioaa	镴
lsiuov	拉
lsivia	俩
lso	啦
lsoi	旯
lsoiua	旯
lsoiuo	啦
lsov	辣
lsovi	喇
lsovia	喇
lsovv	瘌
lsovvi	癞 辣 瘌
lsu	腊
lsua	𬶟
lsuavi	𬶟
lsuvii	腊
lsv	垃
lsvi	剌
lsvii	鞡
lsviii	剌
lsviiu	鞡
lsvoov	垃
lsvu	砬
lsvuov	砬
lt	乱
lta	滦
ltaovi	滦
lto	峦
ltov	孪
ltova	娈
ltovai	孪
ltovau	娈
ltovi	銮
ltovia	脔 峦
ltovio	銮
ltoviu	挛
ltovu	鸾
ltovua	鸾
ltovv	栾
ltovvv	栾
ltu	卵
ltuaai	卵
ltuvaa	乱
lw	类
lwa	泪
lwaa	纶
lwaai	缧
lwaaia	缧
lwaaiu	纶
lwai	沦
lwaia	漯
lwaiav	泪 漯
lwaiua	沦
lwao	垒
lwaovo	垒
lwau	嫘
lwauia	嫘
lwi	累
lwia	囵
lwiaaa	累
lwiaiu	囵
lwiau	罍
lwiauv	罍
lwii	伦
lwiia	儡
lwiiav	儡
lwiii	藟
lwiiia	藟
lwiiua	伦
lwiiv	蕾
lwiivo	蕾
lwio	镭
lwioi	𬬭
lwioiu	𬬭
lwiovo	镭
lwiu	仑
lwiuaa	仑
lwiui	抡
lwiuiu	抡
lwiuv	擂
lwiuvo	擂
lwo	论
lwoa	诔
lwoaiu	论
lwoavv	诔
lwouvu	类
lwov	羸
lwovi	嘞
lwovii	嘞
lwovou	羸
lwovv	癗
lwovvo	癗
lwu	肋
lwuauu	肋
lwv	轮
lwvaiu	轮
lwvi	勒
lwviau	勒
lwviu	酹
lwviuo	酹
lwvo	雷
lwvoi	𫭢
lwvoia	雷
lwvoiu	𫭢
lwvu	磊
lwvuv	礌
lwvuvo	礌
lwvuvu	磊
lwvv	耒
lwvvo	檑
lwvvoa	檑
lwvvvi	耒
lx	两
lxa	梁
lxaa	粱
lxaao	𫟅
lxaaou	粱
lxaaov	𫟅
lxaavv	梁
lxi	俩
lxii	莨
lxiioa	莨
lxiiv	𬜯
lxiivi	𬜯
lxio	俍
lxioav	俍
lxiov	倞
lxiovo	倞
lxivia	俩
lxo	量
lxoa	良
lxoao	谅
lxoaov	谅
lxoavv	良
lxoi	晾
lxoiia	量
lxoio	踉
lxoioa	踉
lxoiov	晾
lxoo	悢
lxoooa	悢
lxou	粮
lxouoa	粮
lxov	亮
lxovo	凉
lxovov	凉
lxovua	亮
lxu	魉
lxuivi	魉
lxv	辆
lxva	辌
lxvaov	辌
lxvavi	辆
lxviau	两
lxvo	椋
lxvoa	墚
lxvoaa	墚
lxvovo	椋
lxvv	靓
lxvvia	靓
ly	龙
lya	隆
lyaa	漋
lyaaiu	漋
lyai	陇
lyaiua	隆
lyaivu	陇
lyav	泷
lyavua	泷
lyi	拢
lyia	眬
lyiavu	眬
lyii	茏
lyiivu	茏
lyiuvu	拢
lyo	咙
lyoi	昽
lyoivu	昽
lyoo	窿
lyooai	窿
lyov	癃
lyovai	癃
lyovua	咙
lyovv	哢
lyovvi	哢
lyu	笼
lyuv	胧
lyuvua	胧
lyuvv	𬕂
lyuvvi	𬕂
lyuvvu	笼
lyv	垄
lyvu	聋
lyvua	尨
lyvuau	龙 尨
lyvuv	砻
lyvuvi	聋
lyvuvo	垄
lyvuvu	砻
lyvv	弄
lyvvu	栊
lyvvua	栊
lyvvv	珑
lyvvvu	弄 珑
lz	老
lza	姥
lzaa	络
lzaaua	络
lzai	涝
lzaiio	涝
lzau	嫪
lzauao	嫪
lzauuo	姥
lzav	潦
lzavuo	潦
lzi	劳
lzia	崂
lziaii	崂
lzii	落
lziiau	劳 落
lziiu	荖
lziiuo	荖
lzio	铑
lzioi	铹
lzioii	铹
lziouo	铑
lziu	捞
lziuii	捞
lziuo	佬
lziuov	佬
lzo	牢
lzoi	唠
lzoiio	唠
lzoouv	牢
lzou	烙
lzouua	烙
lzov	痨
lzovii	痨
lzu	乐
lzuaiu	乐
lzuoua	老
lzv	酪
lzvi	醪
lzviao	醪
lzviua	酪
lzvo	𫭼
lzvoii	𫭼
lzvu	栳
lzvuov	栳
lzvv	耢
lzvvii	耢
m	没
mb	民
mba	泯
mbaa	缗
mbaaav	缗
mbaav	湣
mbaava	泯 湣
mbav	愍
mbavav	民
mbavoa	愍
mbi	皿
mbia	岷
mbiaav	岷
mbiaii	皿
mbii	苠
mbiiav	苠
mbiu	抿
mbiuav	抿
mbo	闽
mboi	闵
mboia	黾
mboiav	黾
mboiia	闽
mboio	旻
mboiov	闵 旻
mboo	悯
mboooi	悯
mbov	忞
mbovoa	忞
mbu	敏
mbuv	鳘
mbuvua	鳘
mbuvuv	敏
mbv	玟
mbvu	碈
mbvuua	碈
mbvv	珉
mbvvav	珉
mbvvov	玟
mc	秒
mca	妙
mcaa	淼
mcaaa	缪
mcaaaa	淼
mcaaao	缪
mcaai	缈
mcaaia	缈
mcai	渺
mcaiav	渺
mcauiu	妙
mci	苗
mcia	瞄
mciai	眇
mciaii	瞄
mciaiu	眇
mcii	藐
mciiia	苗
mciiu	鹋
mciiua	鹋
mciiuo	藐
mciu	描
mciuii	描
mco	庙
mcoi	喵
mcoiii	喵
mcovia	庙
mcu	邈
mcuooa	邈
mcuviu	秒
mcv	杪
mcviuo	杪
md	某
mda	牟
mdaa	乜
mdaaa	缪 乜
mdaaao	缪
mdao	鍪
mdaoio	鍪
mdaouv	牟
mdi	眸
mdiaa	蛑
mdiaao	眸 蛑
mdiao	侔
mdiaou	侔
mdii	蔑
mdiiia	蔑
mdo	谋
mdoa	哞
mdoaou	哞
mdoavi	谋
mdoo	咩
mdoouv	咩
mdu	篾
mduvia	篾
mdv	灭
mdvivv	某
mdvoui	灭
me	么
meo	麽
meovua	麽
meuaoo	么
mev	末
mevviu	末
mf	满
mfa	漫
mfaa	缦
mfaaoi	缦
mfaiiv	满
mfaoii	漫
mfau	嫚
mfauoi	嫚
mfav	𬇕
mfavau	𬇕
mfi	瞒
mfia	幔
mfiai	螨
mfiaii	瞒 螨
mfiaoi	幔
mfii	蔓
mfiio	𬜬
mfiioi	蔓 𬜬
mfiiv	颟
mfiivu	颟
mfio	镘
mfiooi	镘
mfo	慢
mfoa	谩
mfoaoi	谩
mfoi	曼
mfoiia	曼
mfoooi	慢
mfov	蛮
mfovia	蛮
mfu	馒
mfua	鳗
mfuaoi	馒 鳗
mfv	埋
mfvi	鞔
mfvio	鬘
mfvioi	鬘
mfviua	鞔
mfvo	墁
mfvoia	埋
mfvooi	墁
mg	名
mga	溟
mgaoao	溟
mgau	洺
mgauao	洺
mgi	命
mgia	瞑
mgiao	螟
mgiaoa	瞑 螟
mgii	茗
mgiio	蓂
mgiioi	蓂
mgiiua	茗
mgio	铭
mgioua	铭
mgivoa	命
mgo	明
mgoa	冥
mgoaoi	冥
mgoi	暝
mgoioa	暝
mgoiuu	明
mgou	鸣
mgouao	鸣
mguaoo	名
mgv	酩
mgviua	酩
mh	买
mhaoov	买
mhi	荬
mhiiao	荬
mhio	鿏
mhiovv	鿏
mho	唛
mhovvi	唛
mhu	卖
mhuo	脉
mhuoaa	脉
mhuoao	卖
mhv	埋
mhva	迈
mhvaa	劢
mhvaau	劢
mhvaoa	迈
mhvo	霾
mhvoia	埋
mhvouo	霾
mhvv	麦
mhvvua	麦
mj	目
mja	母
mjaaov	母
mjao	牟
mjaouv	牟
mjau	姆
mjauaa	姆
mjauu	姥
mjauuo	姥
mjav	沐
mjavv	沐
mji	幕
mjia	睦
mjiavo	睦
mjiavv	目
mjii	墓
mjiia	募
mjiiau	募
mjiii	慕
mjiiia	苜 幕
mjiiiu	慕
mjiio	暮
mjiioi	暮
mjiivo	墓
mjio	钼
mjioa	𬭁
mjioaa	𬭁
mjioia	钼
mjiu	拇
mjiua	仫
mjiuaa	拇
mjiuao	仫
mjo	亩
mjoi	𧿹
mjoiaa	𧿹
mjovia	亩
mju	牧
mjuv	穆
mjuva	毪
mjuvao	毪
mjuvui	穆
mjuvuv	牧
mjuvv	牡
mjuvvo	牡
mjv	木
mjvi	模
mjviio	模
mjvv	木
mk	米
mka	弥
mkao	泌
mkaoao	泌
mkaoi	汨
mkaoii	汨
mkaou	洣
mkaouv	洣
mkav	弭
mkavua	弥
mkavvi	弭
mki	眯
mkiaou	眯
mkii	蘼
mkiio	蓂
mkiioi	蓂
mkiiov	蘼
mkiv	芈
mkivvv	芈
mko	密
mkoa	谜
mkoai	幂
mkoaia	幂
mkoao	谧
mkoaoa	祕 谧
mkoaou	谜
mkoau	祢
mkoaua	祢
mkoi	日
mkoii	日
mkoo	蜜
mkooia	密 蜜
mkooo	宓
mkoooa	嘧 宓
mkoou	咪
mkoouv	咪
mkou	迷
mkouoa	迷
mkouu	敉
mkouuv	敉
mkouvv	米
mkov	靡
mkova	縻
mkovaa	縻
mkoviv	靡
mkovo	糜
mkovou	麋 糜
mku	秘
mkua	猕
mkuaav	猕
mkuo	觅
mkuoia	觅
mkuou	脒
mkuouv	脒
mkuvoa	秘
mkv	醚
mkvi	醾
mkviou	醚
mkviov	醾
ml	摸
mla	漠
mlaa	𬙊
mlaaia	𬙊
mlai	陌
mlaiio	漠
mlaivu	陌
mlau	嬷
mlauaa	没
mlaui	嫫
mlauii	嫫
mlauov	嬷
mlav	沫
mlavvi	沫
mli	莫
mlia	默
mliai	冒
mliaia	冒
mliav	墨
mliavo	墨
mliavu	默
mlii	摹
mliia	蓦
mliiaa	蓦
mliiiu	摹
mliio	蘑
mliioi	莫
mliiov	藦 蘑
mliiv	茉
mliivv	茉
mlio	镆
mlioii	镆
mliu	抹
mliuii	摸
mliuvv	抹
mlo	魔
mloa	谟
mloaii	谟
mloia	嘿
mloiao	嘿
mloo	寞
mlooii	寞
mlov	磨
mlovi	摩
mlovii	瘼
mloviu	摩
mlovu	麽
mlovua	麽
mlovui	魔
mlovvu	磨
mlu	膜
mlua	馍
mluaii	馍
mluao	么
mluaoo	么
mluiio	膜
mluo	貘
mluoa	脉
mluoaa	脉
mluoii	貘
mluou	貉
mluoua	貉
mluov	貊
mluovu	貊
mluv	秣
mluvvv	秣
mlv	末
mlva	万
mlvauu	万
mlvi	模
mlviio	模
mlviv	靺
mlvivv	靺
mlvu	殁
mlvuua	殁
mlvv	无
mlvviu	末
mlvvo	耱
mlvvov	耱
mlvvua	无
mm	面
mma	绵
mmaa	缅
mmaaui	绵
mmaavu	缅
mmao	渑
mmaoia	渑
mmau	娩
mmauua	娩
mmav	湎
mmavi	沔
mmavia	沔
mmavui	湎
mmi	眠
mmia	冕
mmiaav	眠
mmiaua	冕
mmiav	眄
mmiavi	眄
mmiv	偭
mmivui	偭
mmo	黾
mmoiav	黾
mmoo	愐
mmoovu	愐
mmu	免
mmua	勉
mmuaau	勉
mmuaia	免
mmuau	𩾃
mmuaua	𩾃
mmuv	腼
mmuvui	腼
mmv	棉
mmvi	丏
mmviaa	丏
mmvu	勔
mmvuau	勔
mmvuia	面 棉
mn	们
mna	懑
mnaioa	懑
mnao	汶
mnaoo	呇
mnaovu	汶
mni	扪
mnio	钔
mnioia	们
mniooi	钔
mniuoi	扪
mno	门
mnoi	闷
mnoiaa	门
mnoioa	闷
mnou	焖
mnouoi	焖
mnov	亹
mnovui	亹
mnv	鞔
mnviua	鞔
mnvv	𫞩
mnvvii	𫞩
mp	忙
mpa	漭
mpaiiv	漭
mpi	茫
mpia	蟒
mpiaii	蟒
mpii	莽
mpiiao	茫
mpiio	芒
mpiiov	芒
mpiivu	莽
mpo	盲
mpooov	忙
mpov	氓
mpova	邙
mpovai	邙
mpovav	氓
mpovia	盲
mpu	牤
mpuv	牻
mpuvov	牤
mpuvvu	牻
mpv	硭
mpvo	杧
mpvova	杧
mpvu	厖
mpvua	尨
mpvuau	尨
mpvuii	硭
mpvuvu	厖
mq	谬
mqa	缪
mqaaao	缪
mqoaao	谬
mr	梦
mra	孟
mraia	勐
mraiau	勐
mraiia	孟
mri	蒙
mria	蠓
mriaa	蜢
mriaai	蜢
mriai	幪
mriaii	㠓 蟒 蠓 幪
mriao	虻
mriaov	虻
mrii	萌
mriii	瞢
mriiia	瞢
mriioi	萌
mriiu	鹲
mriiua	鹲
mriiv	甍
mriiva	甍
mriivv	蒙
mrio	锰
mrioai	锰
mro	盟
mroi	黾
mroia	𫑡
mroiai	𫑡
mroiav	黾
mroiia	盟
mroo	懵
mrooii	懵
mrov	氓
mrovav	氓
mru	猛
mrua	獴
mruaai	猛
mruaii	獴
mrui	朦
mruiio	朦
mruu	艨
mruua	艋
mruuai	艋
mruuii	艨
mrv	檬
mrviio	檬
mrvu	礞
mrvua	尨
mrvuau	尨
mrvuii	礞
mrvvua	梦
ms	吗
msa	妈
msaa	马
msaavv	马
msai	孖
msaiai	孖
msauaa	妈
msi	抹
msia	蚂
msiaaa	蚂
msiai	蟆
msiaii	蟆
msiuvv	抹
mso	嘛
msoa	祃
msoaaa	祃
msoaav	吗
msoo	骂
msooaa	骂
msoovu	嘛
msov	麻
msovi	摩
msoviu	摩
msovvv	麻
msu	犸
msua	么
msuaaa	犸
msuaoo	么
msv	码
msva	杩
msvaav	杩
msvuaa	码
msvv	玛
msvvaa	玛
mw	每
mwa	妹
mwaa	湄
mwaaiv	湄
mwai	眉
mwaia	郿
mwaiai	郿
mwaiia	眉
mwaiu	鹛
mwaiua	鹛
mwao	渼
mwaouv	渼
mwau	媒
mwaua	媚
mwauaa	没
mwauai	浼 媚
mwauo	媄
mwauou	媄
mwauvi	媒
mwauvv	妹
mwi	嵋
mwiaai	嵋
mwii	莓
mwiiuv	莓
mwio	镁
mwioa	镅
mwioai	镅
mwioou	镁
mwo	美
mwoa	袂
mwoaav	袂
mwoao	谜
mwoaou	谜
mwoi	昧
mwoivv	昧
mwoo	寐
mwooai	寐
mwou	煤
mwouvi	煤
mwouvu	美
mwov	糜
mwovou	糜
mwu	魅
mwuivv	魅
mwuvaa	每
mwv	梅
mwva	楣
mwvaiv	楣
mwvi	酶
mwviuv	酶
mwvo	霉
mwvouv	霉
mwvu	枚
mwvuva	梅
mwvuvu	枚
mwvv	玫
mwvva	瑂
mwvvai	瑂
mwvvuv	玫
mz	毛
mza	矛
mzao	蟊
mzaoai	矛
mzaoi	瞀
mzaoia	蝥 蟊 瞀
mzau	泖
mzauau	泖
mzi	冒
mzia	帽
mziaia	冒 帽
mziau	峁
mziaua	峁
mziauv	眊
mzii	茂
mziia	茅
mziiai	鄚
mziiao	茅
mziiu	茆
mziiua	茆
mziiuv	芼
mziivu	茂
mzio	锚
mzioii	锚
mziou	铆
mzioua	铆
mzo	袤
mzoi	昴
mzoiua	昴
mzov	旄
mzovao	袤
mzovuv	旄
mzu	贸
mzua	猫
mzuaa	卯
mzuaai	卯
mzuaao	贸
mzuaii	猫
mzuo	貌
mzuou	耄
mzuoui	貌
mzuouv	耄
mzuv	牦
mzuvuv	牦
mzuvva	毛
mzv	髦
mzva	懋
mzvao	楙
mzvaoa	懋 楙
mzviuv	髦
mzvv	瑁
mzvvia	瑁
n	你
nb	您
nbi	恁
nbiuoa	您 恁
nc	鸟
nca	尿
ncaa	溺
ncaava	溺
ncavaa	尿
nci	茑
nciiua	茑
ncu	袅
ncua	脲
ncuaoa	鸟
ncuaov	袅
ncuavu	脲
nd	捏
nda	涅
ndaa	乜
ndaaa	乜
ndai	陧
ndaioi	陧
ndaoiv	涅
ndi	孽
ndia	嵲
ndiaui	嵲
ndii	蘖
ndiiai	孽
ndiii	菍
ndiiio	菍
ndiio	糵
ndiiou	糵
ndiivv	蘖
ndio	镊
ndiou	镍
ndioui	镍
ndiovi	镊
ndiu	摄
ndiuoi	捏
ndiuvi	摄
ndo	蹑
ndoi	啮
ndoiu	𫔶
ndoiui	𫔶
ndoivi	蹑 啮
ndov	嗫
ndovii	嗫
ndu	臬
nduivv	臬
ndv	聂
ndvi	颞
ndviao	聂
ndvivu	颞
ndvv	耨
ndvvvu	耨
ne	呢
nea	那
neavai	那
neo	讷
neoa	哪
neoaia	讷
neoavu	呢
neoavv	哪
neoi	呐
neoiau	呐
nf	难
nfa	婻
nfaoio	难
nfauuo	婻
nfi	男
nfia	囡
nfiaau	男 囡
nfiau	蝻
nfiauo	蝻
nfii	萳
nfiiuo	萳
nfo	喃
nfouoi	喃
nfu	南
nfuoia	南
nfuu	腩
nfuuoi	腩
nfv	楠
nfvo	赧
nfvoai	赧
nfvuoi	楠
ng	宁
nga	泞
ngaooa	泞
ngi	拧
ngii	苧
ngiioo	苧
ngiuoo	拧
ngiv	佞
ngivva	佞
ngo	凝
ngoo	咛
ngooi	甯
ngooia	甯
ngoooa	咛
ngoovi	宁
ngovua	凝
ngu	狞
nguaoo	狞
ngv	柠
ngvi	聍
ngvioo	聍
ngvooa	柠
nh	乃
nha	奶
nhao	能
nhaoua	能
nhau	鼐
nhauau	奶
nhauia	鼐
nhauu	乃
nhi	虐
nhii	艿
nhiiau	艿
nhiiv	萘
nhiivu	萘
nhiv	佴
nhivii	佴
nhivva	虐
nho	疟
nhoav	哪
nhoavv	哪
nhovva	疟
nhu	氖
nhuvau	氖
nhv	耐
nhvi	迺
nhvioa	迺
nhvu	奈
nhvuu	耏
nhvuuu	耏
nhvuvi	耐
nhvuvv	奈
nhvv	柰
nhvvvi	柰
nj	怒
nja	奴
njau	努
njaua	弩
njauaa	驽
njauai	孥
njauao	奴
njauau	努
njauav	弩
njaui	胬
njauia	胬
njauoa	怒
njauv	砮
njauvu	砮
nji	傉
njivuv	傉
njo	呶
njoauv	呶
nju	笯
njuvau	笯
nk	泥
nka	尼
nkaa	溺
nkaava	溺
nkaavu	泥
nkai	𨺙
nkaiui	𨺙
nkau	妮
nkauav	妮
nkavua	尼
nki	拟
nkia	睨
nkiaui	睨
nkiav	伲
nkiavu	伲
nkii	薿
nkiiua	薿
nkio	铌
nkioav	铌
nkiu	倪
nkiuai	你
nkiuao	拟
nkiuiv	倪
nkiv	𫠜
nkivui	𫠜
nko	呢
nkoavu	呢
nkoi	昵
nkoiav	昵
nkoo	怩
nkooav	怩
nkou	逆
nkouoa	逆
nkov	旎
nkovu	麑
nkovui	麑
nkovuv	旎
nku	腻
nkua	猊
nkuaa	疑
nkuaao	疑
nkuau	鲵
nkuaui	猊 鲵
nkuvvv	腻
nkv	匿
nkva	𫐐
nkvaui	𫐐
nkviiv	匿
nkvo	霓
nkvoa	坭
nkvoav	坭
nkvoui	霓
nl	女
nla	娜
nlauav	娜
nlauvv	女
nlav	那
nlavai	那
nli	挪
nlia	傩
nliaoi	傩
nlii	𦰡
nliiav	𦰡
nlio	钕
nlioau	钕
nlioi	锘
nlioii	锘
nliu	搦
nliuav	挪 搦
nlo	诺
nloaii	诺
nloi	喏
nloiiv	喏
nloo	懦
nloovo	懦
nlou	糯
nlouvo	糯
nlu	衄
nluiai	衄
nlv	恧
nlvuoa	恧
nm	年
nmi	念
nmii	蔫
nmiivi	蔫
nmiooa	念
nmiu	撵
nmiui	捻
nmiuio	捻
nmiuiv	拈
nmiuvv	撵
nmo	粘
nmouiv	粘
nmu	黏
nmua	鲇
nmuaiv	鲇
nmuviv	黏
nmuvvi	年
nmv	廿
nmva	辗
nmvaav	辗
nmviiv	廿
nmvo	埝
nmvoio	埝
nmvu	碾
nmvuav	碾
nmvv	辇
nmvvva	辇
nn	嫩
nna	媆
nnauvi	嫩
nnauvu	媆
nni	恁
nniuoa	恁
npi	攮
npiuvi	攮
npo	囔
npoi	曩
npoiov	曩
npovia	囔
npu	馕
npuavi	馕
npui	齉
npuivi	齉
npv	囊
npvioo	囊
nq	牛
nqa	妞
nqaa	纽
nqaaai	纽
nqauai	妞
nqi	扭
nqio	钮
nqioai	钮
nqiu	拗
nqiuaa	拗
nqiuai	扭
nqo	忸
nqooai	忸
nqu	狃
nquaai	狃
nquvvi	牛
nqv	杻
nqvaiv	杻
nr	能
nraoua	能
ns	那
nsa	纳
nsaaia	纳
nsai	乸
nsaiaa	乸
nsau	娜
nsauav	娜
nsavai	那
nsi	拿
nsiau	内
nsiauo	内
nsii	𦰡
nsiiav	𦰡
nsio	钠
nsioi	镎
nsioia	钠
nsioiv	镎
nsiu	捺
nsiuvu	捺
nsiviu	拿
nso	哪
nsoa	衲
nsoaia	衲
nsoavv	哪
nsoi	呐
nsoiau	呐
nsu	南
nsui	肭
nsuiau	肭
nsuoia	南
nt	暖
ntoiuo	暖
nw	内
nwa	那
nwavai	那
nwiauo	内
nwo	哪
nwoavv	哪
nwu	馁
nwuauo	馁
nx	娘
nxauoa	娘
nxv	酿
nxvioa	酿
ny	弄
nya	浓
nyaoau	浓
nyi	侬
nyioau	侬
nyo	农
nyoaua	农
nyoo	哝
nyooau	哝
nyu	脓
nyuoau	脓
nyuv	秾
nyuvoa	秾
nyv	𬪩
nyvioa	𬪩
nyvvvu	弄
nz	闹
nza	淖
nzaivo	淖
nzi	挠
nzia	蛲
nziava	蛲
nzio	铙
nziova	铙
nziuva	挠
nzo	恼
nzoa	呶
nzoauv	呶
nzoiov	闹
nzooov	恼
nzu	脑
nzua	猱
nzuaa	峱
nzuaai	峱
nzuaao	猱
nzuovu	脑
nzuv	臑
nzuvoa	臑
nzv	孬
nzvo	垴
nzvoov	垴
nzvu	硇
nzvuau	孬
nzvuui	硇
nzvv	瑙
nzvva	桡
nzvvaa	瑙
nzvvau	桡
p	平
pb	品
pba	姘
pbau	嫔
pbauoo	嫔
pbauou	姘
pbi	拼
pbii	𬞟
pbiiiv	𬞟
pbiuou	拼
pbiv	频
pbivu	颦
pbivui	颦
pbivvu	频
pboooo	品
pbu	贫
pbuoao	贫
pbuv	牝
pbuvua	牝
pbv	聘
pbviia	聘
pbvv	玭
pbvvva	玭
pc	票
pca	漂
pcaa	缥
pcaav	骠
pcaavi	缥 骠
pcau	嫖
pcauvi	嫖
pcavia	漂
pci	瞟
pcia	螵
pciavi	瞟 螵
pcii	薸
pciiav	薸
pciiu	莩
pciiuo	莩
pciiv	蔈
pciivi	蔈
pco	嘌
pcovia	嘌
pcu	膘
pcuvia	膘
pcv	飘
pcvi	瓢
pcvii	剽
pcviii	剽
pcvio	朴
pcvioo	朴
pcviua	飘
pcviuu	瓢
pcvivv	票
pcvu	殍
pcvuuo	殍
pd	撇
pdi	苤
pdiivu	苤
pdio	𬭯
pdioou	𬭯
pdiu	抔
pdiuo	掊
pdiuou	撇
pdiuov	掊
pdiuvu	抔
pdo	瞥
pdouia	瞥
pdov	剖
pdovii	剖
pdovu	裒
pdovui	裒
pdu	氕
pduvuu	氕
pdv	垺
pdvouo	垺
pf	盘
pfa	潘
pfai	爿
pfaivu	爿
pfao	泮
pfaouv	泮
pfauou	潘
pfi	盼
pfia	畔
pfiaou	畔
pfiau	蟠
pfiauo	盼 蟠
pfiu	拌
pfiuou	拌
pfiuu	扳
pfiuuu	扳
pfo	判
pfoa	袢
pfoaou	袢
pfoav	襻
pfoavu	襻
pfoi	蹒
pfoiii	蹒
pfou	叛
pfouii	判
pfouuu	叛
pfu	磐
pfuo	胖
pfuoi	番
pfuoia	番
pfuouv	胖
pfuu	槃
pfuuia	盘
pfuuu	般
pfuuua	般
pfuuvu	磐
pfuuvv	槃
pfv	攀
pfvo	柈
pfvouv	柈
pfvu	磻
pfvuuo	磻
pfvuvu	攀
pg	凭
pga	屏
pgai	涄
pgaiav	涄
pgao	洴
pgaouv	洴
pgau	娉
pgauia	娉
pgauu	淜
pgauuu	淜
pgav	泙
pgavou	屏 泙
pgi	萍
pgia	帡
pgiaou	帡
pgiav	蚲
pgiavo	蚲
pgii	苹
pgiia	俜
pgiiav	萍 俜
pgiii	𬞟
pgiiiv	𬞟
pgiio	荓
pgiiou	荓
pgiivo	苹
pgiuua	凭
pgo	瓶
pgoa	评
pgoavo	评
pgouva	瓶
pgov	冯
pgovaa	冯
pgu	乒
pgua	鲆
pguavo	鲆
pguiuu	乒
pgv	坪
pgvouv	平
pgvovo	坪
pgvv	枰
pgvvou	枰
pgvvv	玶
pgvvvo	玶
ph	排
pha	派
phai	湃
phaiuv	湃
phauuu	派
phi	拍
phii	俳
phiia	蒎
phiiau	蒎
phiivv	俳
phiuiv	排
phiuui	拍
pho	哌
phouuu	哌
phu	牌
phui	迫
phuioa	迫
phuiui	牌
phuu	徘
phuuiv	徘
phuv	簰
phuvui	簰
pj	普
pja	浦
pjai	濮
pjaiii	濮
pjao	瀑
pjaoiv	瀑
pjaou	潽
pjaouv	潽
pjav	溥
pjavia	浦 溥
pji	扑
pjia	圃
pjiavi	圃
pjii	仆
pjiia	蒲
pjiiav	蒲
pjiii	蒱
pjiiiu	蒱
pjiio	菩
pjiioo	仆
pjiiov	菩
pjiiu	葡
pjiiua	葡
pjiiv	莆
pjiivi	莆
pjio	铺
pjioi	镤
pjioii	镤
pjioo	镨
pjioou	镨
pjiov	堡
pjiovi	铺
pjiovo	堡
pjiuio	扑
pjo	谱
pjoaou	谱
pjoi	蹼
pjoii	噗
pjoiii	蹼
pjoiio	噗
pjoio	曝
pjoioi	曝
pjoiv	暴
pjoivi	暴
pjouoi	普
pju	脯
pjua	匍
pjuavi	匍
pjuv	氆
pjuvi	穙
pjuvia	脯
pjuvii	穙
pjuvou	氆
pjv	朴
pjvi	酺
pjvioo	朴
pjvivi	酺
pjvo	埔
pjvoi	墣
pjvoii	墣
pjvovi	埔
pjvv	璞
pjvvii	璞
pk	批
pka	皮
pkaa	纰
pkaav	澼
pkaava	纰
pkaavu	𬳵 澼
pkai	淠
pkaia	陂
pkaiau	陂
pkaiav	淠
pkaiu	陴
pkaiui	陴
pkau	媲
pkauao	皮
pkaui	濞
pkauia	濞
pkauui	媲
pkav	辟
pkava	劈
pkavau	劈
pkavo	譬
pkavov	辟 譬
pkavu	䴙
pkavua	䴙
pkavv	屁
pkavva	甓 屁
pki	披
pkia	僻
pkiao	罴
pkiaoo	罴
pkiau	睥
pkiaui	蜱 睥
pkiav	毗
pkiava	蚍 毗
pkiavo	罢
pkiavu	僻
pkii	芘
pkiiv	苉
pkiiva	芘
pkiivu	苉
pkio	铍
pkioau	铍
pkiuau	披
pkiuva	批
pkiv	仳
pkivau	仳
pkivu	伾
pkivui	伾
pko	疲
pkoa	裨
pkoaa	被
pkoaau	被
pkoaui	裨
pkoav	噼
pkoavu	噼
pkou	啤
pkouia	啤
pkov	癖
pkova	吡
pkovau	疲 吡
pkovav	癖
pkovv	痞
pkovvu	痞
pku	脾
pkua	鲏
pkuaau	鲏
pkuav	狉
pkuavu	狉
pkui	郫
pkuiai	郫
pkuo	貔
pkuoui	貔
pkuuia	脾
pkv	匹
pkvo	霹
pkvoa	圮
pkvoav	霹 圮
pkvou	埤
pkvoui	鼙 埤
pkvov	坯
pkvovu	嚭 坯
pkvu	丕
pkvua	邳
pkvuaa	匹
pkvuai	邳
pkvui	椑
pkvuia	椑
pkvuo	否
pkvuoo	否
pkvuv	砒
pkvuva	砒
pkvuvv	丕
pkvv	琵
pkvva	枇
pkvvau	枇
pkvvva	琵
pl	破
pla	婆
plaa	泼
plaaau	婆
plaaua	泼
plai	陂
plaiau	陂
plau	颇
plaua	泺
plauai	泺
plaui	泊
plauia	泊
plauvu	颇
pli	钋
plio	钷
plioa	䥽
plioau	䥽
plioio	钋
pliovo	钷
plo	跛
ploiau	跛
plou	粕
plouo	哱
plouoo	哱
plouui	粕
plu	迫
plui	魄
pluioa	迫
pluiu	皤
pluiui	魄
pluiuo	皤
pluo	鄱
pluoai	鄱
pluv	笸
pluva	繁
pluvaa	繁
pluvvo	笸
plv	坡
plvi	朴
plvia	酦
plviau	酦
plvioo	朴
plvo	叵
plvoaa	叵
plvoau	坡
plvu	桲
plvuau	破
plvuoo	桲
plvv	珀
plvvui	珀
pm	片
pma	骗
pmaa	骈
pmaaoa	骗
pmaaou	骈
pmau	㛹
pmauiv	㛹
pmi	偏
pmioav	偏
pmiv	便
pmivia	便
pmo	翩
pmoa	扁
pmoaao	翩
pmoaia	扁
pmoao	谝
pmoaoa	谝
pmoi	蹁
pmoioa	蹁
pmu	篇
pmuiva	片
pmuo	胼
pmuouv	胼
pmuv	犏
pmuvoa	篇 犏
pmv	楩
pmvivi	楩
pmvo	𡎚
pmvooa	𡎚
pn	盆
pna	湓
pnauoa	湓
pno	喷
pnouoi	喷
pnuoia	盆
pp	旁
ppa	滂
ppaovo	滂
ppi	螃
ppiaov	螃
ppii	蒡
ppiiov	蒡
ppo	庞
ppoa	房
ppoaov	房
ppovov	旁
ppovvu	庞
ppu	胖
ppua	逄
ppuao	鳑
ppuaoa	逄
ppuaov	鳑
ppui	乓
ppuioo	乓
ppuo	膀
ppuouv	胖
ppuovo	膀
ppuu	彷
ppuuov	彷
ppv	磅
ppvo	雱
ppvoov	雱
ppvu	厖
ppvuov	磅
ppvuvu	厖
ppvv	耪
ppvvov	耪
pr	碰
pra	澎
prau	淜
prauuu	淜
prav	泙
pravoo	澎
pravou	泙
pravu	弸
pravuu	弸
pri	捧
pria	蟛
priavo	蟛
prii	蓬
priiu	芃
priiua	蓬 芃
priiv	苹
priivo	苹
priu	抨
priuo	搒
priuov	搒
priuvo	抨
priuvv	捧
pro	烹
proo	怦
proovo	怦
prov	嘭
provoo	烹 嘭
pru	朋
pruu	鹏
pruuu	朋
pruuua	鹏
pruv	篷
pruvo	膨
pruvoo	膨
pruvua	篷
prv	棚
prvo	彭
prvou	堋
prvouu	彭 堋
prvouv	椪
prvov	榜
prvovo	榜
prvu	砰
prvuou	碰
prvuu	硼
prvuuu	棚 硼
prvuvo	砰
ps	怕
psa	潖
psau	派
psauuu	派
psavvi	潖
psi	帕
psiaui	帕
psii	葩
psiia	芭
psiiai	芭
psiiui	葩
psio	钯
psioai	钯
psiu	扒
psiuuo	扒
pso	啪
psoi	趴
psoiuo	趴
psoiuu	啪
psooui	怕
psou	叭
psouoo	叭
psu	爬
psuu	舥
psuuai	爬 舥
psuv	筢
psuviu	筢
psv	琶
psva	杷
psvaiv	杷
psvv	耙
psvvai	琶 耙
pw	配
pwa	陪
pwaa	辔
pwaao	𬇙
pwaaoo	辔 𬇙
pwai	淠
pwaiav	淠
pwaiov	陪
pwao	赔
pwaoov	赔
pwav	沛
pwavia	沛
pwi	佩
pwia	帔
pwiaau	帔
pwio	锫
pwioov	锫
pwiuav	佩
pwiv	裴
pwivov	裴
pwo	呸
pwov	旆
pwovui	呸
pwovuv	旆
pwu	胚
pwui	衃
pwuivu	衃
pwuvui	胚
pwv	培
pwvi	醅
pwviav	配
pwviov	醅
pwvo	霈
pwvoav	霈
pwvoov	培
pwvov	坏
pwvovu	坏
pz	跑
pza	泡
pzauaa	泡
pzi	抛
pziuua	抛
pzo	炮
pzoa	袍
pzoaua	袍
pzoiua	跑
pzou	咆
pzouaa	咆
pzouua	炮
pzov	疱
pzovu	庖
pzovua	疱 庖
pzu	刨
pzua	狍
pzuaii	刨
pzuau	鲍
pzuaua	狍 鲍
pzuu	脬
pzuuoo	脬
pzv	匏
pzvuua	匏
q	去
qb	亲
qba	沁
qbaa	骎
qbaaav	骎
qbao	矜
qbaoao	沁
qbaoio	矜
qbav	溱
qbavvv	溱
qbi	侵
qbiai	嵚
qbiaio	嵚
qbiavv	侵
qbii	芹
qbiii	芩
qbiiio	芩
qbiiuu	芹
qbio	钦
qbioa	锓
qbioav	锓
qbioo	衾
qbioov	衾
qbioua	钦
qbiov	禽
qbiovu	禽
qbiu	擒
qbiui	揿
qbiuio	擒 揿
qbo	寝
qboi	噙
qboiov	噙
qboo	吣
qbooao	吣
qbooov	寝
qboov	慬
qboovi	慬
qbov	嗪
qbovv	廑
qbovvi	廑
qbovvv	亲 嗪
qbv	秦
qbvi	勤
qbvia	梣
qbviai	梣
qbviau	勤
qbvio	檎
qbvioi	覃
qbviov	檎
qbvv	琴
qbvvio	琴
qbvvuv	秦
qc	桥
qca	缲
qcaaoo	缲
qci	瞧
qcia	峭
qciai	睄
qciaio	瞧 峭 睄
qciau	峤
qciauv	峤
qcii	俏
qciii	蕉
qciiio	蕉
qciiou	俏
qciiu	荞
qciiuv	荞
qcio	锹
qcioi	劁
qcioii	劁
qciouv	锹
qciu	侨
qciui	雀
qciuio	雀
qciuu	撬
qciuuv	撬
qciuvu	侨
qco	悄
qcoa	诮
qcoai	谯
qcoaio	诮 谯
qcoi	跷
qcoiva	跷
qcoo	窍
qcooi	憔
qcooio	悄 憔
qcoou	愀
qcoouv	愀
qcoovi	窍
qcov	敲
qcoviv	敲
qcu	乔
qcuv	毳
qcuvui	乔
qcuvuv	毳
qcv	巧
qcva	翘
qcvaao	翘
qcvi	鞘
qcviio	鞘
qcvio	樵
qcviov	樵
qcviu	鞒
qcviuv	鞒
qcviva	巧
qcvo	壳
qcvoua	壳
qcvu	橇
qcvuu	硚
qcvuuv	硚
qcvuv	硗
qcvuva	硗
qcvuvu	桥
qcvuvv	橇
qd	且
qdi	茄
qdia	伽
qdiauo	伽
qdiavv	且
qdiiau	茄
qdio	锲
qdiovv	锲
qdo	窃
qdoo	怯
qdooo	慊
qdooou	慊
qdoov	惬
qdoova	窃
qdoovo	怯
qdoovv	惬
qdov	妾
qdovau	妾
qdu	箧
qdui	癿
qduiaa	癿
qduo	郄
qduoai	郄
qduvvv	箧
qdv	切
qdvaau	切
qdvo	趄
qdvoia	趄
qdvu	砌
qdvuva	砌
qdvv	挈
qdvviu	挈
qe	着
qea	浙
qeaiuu	浙
qei	折
qeii	蔗
qeiiov	蔗
qeiiu	著
qeiiuo	著
qeio	锗
qeiouo	锗
qeiu	哲
qeiui	蛰
qeiuia	蜇 蛰
qeiuo	晢
qeiuoi	晢
qeiuoo	哲
qeiuuu	折
qeo	遮
qeoa	褶
qeoaao	褶
qeoao	谪
qeoaov	谪
qeoau	褚
qeoauo	褚
qeou	啫
qeouia	着
qeouov	啫
qeov	鹧
qeovi	䗪
qeovia	䗪
qeovii	戢
qeovo	这
qeovoa	遮 这
qeovua	鹧
qeu	者
qeuooi	者
qev	辙
qeva	辄
qevaov	辙
qevavi	辄
qevo	喆
qevou	赭
qevouo	赭
qevovo	喆
qevu	磔
qevuo	詟
qevuov	詟
qevuua	磔
qevv	柘
qevvuo	柘
qf	占
qfa	展
qfaa	绽
qfaaoo	绽
qfai	沾
qfaivo	沾
qfav	湛
qfavii	湛
qfavvi	展
qfi	战
qfia	瞻
qfiau	嶦
qfiaua	瞻 嶦
qfiav	崭
qfiava	崭
qfii	蘸
qfiivi	蘸
qfiu	搌
qfiuav	搌
qfiv	偡
qfivii	偡
qfivoo	占
qfivva	战
qfo	站
qfoa	谵
qfoaua	谵
qfou	粘
qfouiv	粘
qfov	颤
qfoviv	站
qfovu	旃
qfovua	鹯
qfovuv	旃
qfovvu	颤
qfu	詹
qfua	鳣
qfuai	飐
qfuaiv	飐
qfuao	𫗴
qfuaov	詹 鳣 𫗴
qfuv	毡
qfuviv	毡
qfv	斩
qfva	辗
qfvaav	辗
qfvauu	斩
qfvu	栴
qfvuvu	栴
qfvv	盏
qfvvia	盏
qfvvv	栈
qfvvva	栈
qg	请
qga	清
qgaa	𬘬
qgaavv	𬘬
qgavvi	清
qgi	倾
qgia	蜻
qgiao	黥
qgiaov	黥
qgiav	圊
qgiavv	蜻 圊
qgii	擎
qgiii	苘
qgiiia	苘
qgiiiu	擎
qgiiv	檠
qgiivv	檠
qgiv	倩
qgivav	倾
qgivvi	倩
qgo	情
qgoa	綮
qgoaaa	綮
qgoavv	请
qgoi	晴
qgoivv	晴
qgoovv	情
qgov	庆
qgova	勍
qgovau	勍
qgovv	亲
qgovva	庼
qgovvu	庆
qgovvv	亲
qgu	卿
qgua	鲭
qguaav	卿
qguavv	鲭
qguv	氢
qguvao	氢
qguvv	氰
qguvvv	箐 氰
qgv	轻
qgva	顷
qgvaao	轻
qgvavu	顷
qgvo	罄
qgvouv	罄
qgvov	磬
qgvovu	磬
qgvu	碃
qgvuvv	碃
qgvv	青
qgvvuu	青
qh	却
qha	翟
qhaoio	翟
qhi	摘
qhia	侧
qhiaa	𨟠
qhiaai	𨟠
qhiaoi	侧
qhiu	雀
qhiua	择
qhiuao	择
qhiuio	雀
qhiuov	摘
qhiv	债
qhivvi	债
qho	宅
qhoi	阙
qhoia	阕
qhoiao	阕
qhoiou	阙
qhoo	窄
qhoouv	宅 窄
qhoov	寨
qhoovu	𬒈
qhoovv	寨
qhou	炔
qhouav	炔
qhov	斋
qhova	瘸
qhovau	瘸
qhovu	瘵
qhovua	瘵
qhovvu	斋
qhu	缺
qhua	祭
qhuavv	祭
qhuo	豸
qhuoou	豸
qhuvav	缺
qhv	确
qhvi	鹊
qhviua	鹊
qhvo	榷
qhvoai	却
qhvoau	榷
qhvoo	悫
qhvooa	悫
qhvou	埆
qhvoua	埆
qhvu	碏
qhvuua	确
qhvuvi	碏
qj	主
qja	注
qjaa	驻
qjaao	纻
qjaaoo	纻
qjaaov	驻
qjao	贮
qjaooo	贮
qjaovv	注
qjau	渚
qjaua	潴
qjauau	潴
qjauov	渚
qjauv	洙
qjauvv	洙
qjav	属
qjavo	澍
qjavoo	澍
qjavui	属
qji	住
qjia	助
qjiaa	瞩
qjiaau	助
qjiaav	瞩
qjiai	蠋
qjiaia	蠋
qjiao	蛀
qjiaov	蛀
qjiau	蛛
qjiauv	蛛
qjii	著
qjiio	苎
qjiioo	苎
qjiiu	茱
qjiiuo	著
qjiiuv	茱
qjio	铸
qjioo	伫
qjiooa	伫
qjiou	铢
qjiouv	铢
qjiovv	住 铸
qjiu	拄
qjiuov	拄
qjiuv	侏
qjiuvv	侏
qjo	祝
qjoa	诸
qjoao	𬣞
qjoaoo	𬣞
qjoaou	祝
qjoau	诛
qjoauo	褚 诸
qjoauv	诛
qjoav	嘱
qjoavu	嘱
qjoi	躅
qjoiia	躅
qjou	烛
qjouia	烛
qjouo	炷
qjouov	炷
qjov	麈
qjovo	疰
qjovov	麈 疰
qjovv	瘃
qjovvi	主
qjovvu	瘃
qju	朱
qjua	猪
qjuauo	猪
qjuav	橥
qjuavv	橥
qjuo	煮
qjuoa	翥
qjuoao	翥
qjuooo	煮
qjuu	舳
qjuuia	舳
qjuv	竹
qjuva	邾
qjuvai	邾
qjuvu	箸
qjuvuo	箸
qjuvuv	竹
qjuvv	筑
qjuvvi	朱 筑
qjuvvv	竺
qjv	逐
qjva	杼
qjvaoa	杼
qjvo	柱
qjvoa	槠
qjvoau	槠
qjvoo	术
qjvou	柷
qjvoua	柷
qjvovv	柱
qjvu	株
qjvuo	砫
qjvuoa	逐
qjvuov	砫
qjvuvv	株
qjvv	珠
qjvvuv	珠
qk	起
qka	汽
qkaa	骑
qkaao	缉
qkaaov	缉
qkaav	绮
qkaavi	骐
qkaavu	骑 绮
qkai	亟
qkaii	𬮿
qkaiia	𬮿
qkaioa	亟
qkao	泣
qkaoo	呇
qkaovo	泣
qkau	汔
qkauv	婍
qkauva	汔
qkauvu	婍
qkauvv	汽
qkav	漆
qkava	沏
qkavaa	沏
qkavi	淇
qkavia	洓 漆
qkavii	淇
qkavv	柒
qkavvv	柒
qki	企
qkia	岂
qkiaa	屺
qkiaav	岂 屺
qkiao	蛴
qkiaou	俟
qkiaov	蛴
qkiau	岐
qkiauo	岐
qkiav	崎
qkiavi	蜞
qkiavo	畦
qkiavu	崎
qkii	芪
qkiia	芑
qkiiav	芑
qkiio	葺
qkiiou	蕲
qkiiov	荠 葺
qkiiua	芪
qkiiv	萋
qkiiva	萋
qkiivi	萁 企
qkiivu	䓫
qkio	锜
qkiovu	锜
qkiu	伎
qkiuo	揭
qkiuoa	伎
qkiuoi	揭
qkiv	歧
qkivuo	歧
qko	齐
qkoa	启
qkoaa	祁
qkoaaa	綮
qkoaai	祁
qkoaoo	启
qkoau	祈
qkoaua	祇
qkoauu	祈
qkoauv	讫
qkoav	祺
qkoavi	祺
qkoavv	棨
qkoi	蹊
qkoiu	跂
qkoiuo	蹊 跂
qkoiv	踦
qkoivu	踦
qkoo	器
qkoou	愭
qkoouo	愭
qkoovu	器
qkov	弃
qkovu	旗
qkovui	嘁 齐
qkovuv	旗
qkovv	凄
qkovva	凄
qkovvi	麒
qkovvu	弃
qku	气
qkua	鳍
qkuauo	鳍
qkuav	鲯
qkuavi	鲯
qkuo	脐
qkuoa	𨙸
qkuoai	𨙸
qkuoo	耆
qkuooi	耆
qkuovu	脐
qkuu	颀
qkuuvu	颀
qkuv	迄
qkuva	乞
qkuvaa	乞
qkuvo	憩
qkuvoa	迄 憩
qkuvv	稽
qkuvva	气
qkuvvu	稽
qkv	其
qkva	七
qkvaa	妻 七
qkvaai	郪
qkvaau	妻
qkvau	𬨂
qkvaua	𬨂
qkvav	杞
qkvava	杞
qkvi	期
qkvia	綦
qkviaa	綦
qkviai	桤
qkviu	欺
qkviua	欺
qkviuo	其
qkviuu	期
qkvo	圻
qkvoav	起
qkvouu	圻
qkvov	埼
qkvovu	埼
qkvu	奇
qkvui	戚
qkvuiv	戚
qkvuu	欹
qkvuua	磜 欹
qkvuv	砌
qkvuva	砌
qkvuvo	奇
qkvuvv	碛 碶
qkvv	棋
qkvva	玘
qkvvav	玘
qkvvi	栖
qkvvia	栖
qkvvii	棋
qkvvu	槭
qkvvui	亓 槭
qkvvv	琦
qkvvvi	琪
qkvvvu	契 琦
ql	区
qla	屈
qlaa	驱
qlaavu	驱
qlai	灈
qlaiav	灈
qlav	渠
qlavai	屈
qlavvv	渠
qli	曲
qlia	瞿
qliaa	黢
qliaao	黢
qliai	蛆
qliaia	蛐 蠼 𪨰 岨 蛆
qliaio	瞿
qliau	氍
qliauv	氍
qliav	岖
qliavi	曲
qliavu	岖
qlii	蕖
qliia	䓛
qliiav	蕖 䓛
qliii	蘧
qliiiv	蘧
qliiv	苣
qliiva	苣
qliv	龋
qlivi	觑
qlivia	觑
qlivui	龋
qlo	祛
qloa	诎
qloaai	诎
qloav	袪
qloavo	祛 袪
qloi	阒
qloiia	阒
qlou	焌
qlouao	焌
qlov	癯
qlovia	癯
qlovu	竘
qlovua	竘
qlu	躯
qlua	劬
qluaau	劬
qluau	鸲
qluaua	鸲
qlui	鼩
qluiua	鼩
qluivu	躯
qluu	衢
qluua	朐
qluuao	朐
qluuia	衢
qluv	胠
qluvoa	胠
qlv	取
qlvi	娶
qlviao	取
qlviau	娶
qlvo	趣
qlvoao	去
qlvoi	坥
qlvoia	坥
qlvou	趋
qlvoua	趋
qlvov	𫭟
qlvovi	趣
qlvovu	𫭟
qlvu	磲
qlvuav	磲
qlvuoa	区
qlvuv	戌
qlvuvv	戌
qlvv	璩
qlvviv	璩
qlvvo	㭕
qlvvoa	㭕
qlvvu	麹
qlvvua	麹
qm	前
qma	潜
qmaa	纤
qmaai	缱
qmaaia	缱
qmaauv	纤
qmaav	𬘬
qmaavv	𬘬
qmai	阡
qmaiuv	阡
qmav	浅
qmavv	汧
qmavva	浅
qmavvu	潜 汧
qmi	钱
qmia	遣
qmiai	黔
qmiaio	黔
qmiaoa	遣
qmiav	嵌
qmiavi	嵌
qmiavv	岍
qmii	茜
qmiia	荨
qmiiau	伣
qmiiav	荨
qmiii	蒨
qmiiiv	蒨
qmiiu	芡
qmiiua	芡
qmiiuv	芊
qmiivi	茜
qmio	铅
qmioi	钤
qmioio	钤
qmiou	钎
qmioua	铅
qmiouv	钎
qmiov	钳
qmiovi	钳
qmiovv	钱
qmiu	仟
qmiuo	掮
qmiuoa	掮
qmiuu	扦
qmiuuv	扦
qmiuvi	仟
qmiv	倩
qmivo	虔
qmivoo	佥
qmivov	虔
qmivvi	倩
qmo	谦
qmoa	谴
qmoaia	谴
qmoaou	谦
qmoo	骞
qmooaa	骞
qmooi	悭
qmooii	悭
qmooiu	搴
qmooo	褰
qmooou	慊
qmooov	褰
qmou	歉
qmouua	歉
qmouui	前
qmu	千
qmua	欠
qmuaii	欠
qmuau	鹐
qmuaua	鹐
qmuo	乾
qmuouv	乾
qmuu	愆
qmuua	肷
qmuuai	肷
qmuuoa	愆
qmuv	签
qmuva	犍
qmuvav	犍
qmuvii	千
qmuviv	签
qmuvo	迁
qmuvoa	迁
qmv	牵
qmva	堑
qmvav	椠
qmvavo	堑
qmvavv	椠
qmvi	靬
qmvivv	靬
qmvo	圲
qmvou	墘
qmvouo	墘
qmvouv	圲
qmvu	杄
qmvuo	磏
qmvuou	磏
qmvuuv	牵
qmvuvi	杄
qn	真
qna	阵
qnaa	缜
qnaaa	纼
qnaaav	纼
qnaauo	缜
qnai	浈
qnaiva	阵 浈
qnao	赈
qnaovu	赈
qnav	溱
qnavvv	溱
qni	镇
qnia	帧
qniai	畛
qniaiu	畛
qniaiv	帧
qnii	侦
qniiv	蓁
qniiva	侦
qniivu	葴
qniivv	蓁
qnio	针
qniouo	镇 针
qniu	振
qniuv	揕
qniuvi	揕
qniuvu	振
qniv	贞
qnivao	贞
qno	诊
qnoa	祯
qnoai	袗
qnoaiu	诊 袗
qnoaiv	祯
qnoau	鸩
qnoaua	鸩
qnoauo	禛
qnoi	昣
qnoiiu	昣
qnov	疹
qnoviu	疹
qnu	朕
qnui	胗
qnuiuu	胗
qnuouo	真
qnuouv	朕
qnuv	箴
qnuvu	稹
qnuvuo	稹
qnuvvu	箴
qnv	震
qnva	臻
qnvai	轸
qnvaiu	轸
qnvavv	臻
qnvi	斟
qnvioo	斟
qnviu	鬒
qnviuo	鬒
qnviv	甄
qnviva	桢 甄
qnvo	枕
qnvoau	枕
qnvou	圳
qnvoui	圳
qnvovu	震
qnvu	砧
qnvuiv	砧
qnvv	珍
qnvvi	椹
qnvvii	椹
qnvviu	珍
qnvvu	瑱
qnvvuo	瑱
qnvvv	榛
qnvvvv	瑧 榛
qp	张
qpa	涨
qpaava	涨
qpai	障
qpaiov	障
qpao	账
qpaouv	账
qpaov	漳
qpaovo	漳
qpau	嫜
qpauov	嫜
qpavuv	张
qpi	掌
qpia	帐
qpiao	嶂
qpiaov	幛 蟑 嶂
qpiauv	帐
qpioiu	掌
qpiu	仉
qpiuaa	仉
qpiv	仗
qpivuo	仗
qpo	章
qpoi	暲
qpoiov	暲
qpov	彰
qpova	鄣
qpovai	鄣
qpovo	瘴
qpovov	瘴
qpovuo	章
qpovuu	彰
qpu	胀
qpua	獐
qpuaov	獐
qpuuva	胀
qpuv	长
qpuvao	长
qpv	丈
qpvo	樟
qpvovo	樟
qpvuoo	丈
qpvv	杖
qpvvo	璋
qpvvov	璋
qpvvuo	杖
qq	求
qqa	泅
qqaiai	泅
qqao	巯
qqaoov	巯
qqaov	赇
qqaovi	赇
qqau	湫
qqauvi	湫
qqi	囚
qqia	蚯
qqiaa	虬
qqiaaa	虬
qqiaii	囚
qqiao	蝤
qqiaou	蝤
qqiaui	蚯
qqii	艽
qqiiu	萩
qqiiua	艽
qqiiuv	萩
qqio	𨱇
qqiovi	𨱇
qqiu	仇
qqiuaa	仇
qqiv	俅
qqivio	俅
qqo	酋
qqou	遒
qqouoa	遒
qqouu	糗
qqouui	糗
qqouvi	酋
qqu	秋
qqua	鳅
qquai	龟
qquaia	龟
qquao	訄
qquaov	訄
qquau	犰
qquaua	犰
qquauv	鳅
qqui	丘
qquia	邱
qquiai	邱
qquiu	鼽
qquiua	鼽
qquivi	丘
qquv	鹙
qquvou	秋
qquvua	鹙
qqv	球
qqvi	裘
qqvio	逑
qqvioa	逑
qqviou	鞧
qqviov	求 裘
qqvu	楸
qqvuvi	楸
qqvv	璆
qqvvao	璆
qqvvvi	球
qr	正
qra	烝
qraa	𬘬
qraavv	𬘬
qraioo	烝
qri	挣
qria	睁
qriai	帧
qriaiv	帧
qriau	峥
qriaua	睁 峥
qrii	蒸
qriiai	蒸
qrio	铮
qrioua	铮
qriov	钲
qriovi	钲
qriu	拯
qriuai	拯
qriuua	挣
qro	证
qroa	诤
qroaua	诤
qroavi	证
qroo	怔
qroovi	怔
qrou	郑
qrouai	郑
qrov	症
qrovvi	症
qru	争
qrua	狰
qruaav	争
qruaua	狰
qruav	鲭
qruavv	鲭
qruu	征
qruui	徵
qruuia	徵
qruuvi	征
qruv	筝
qruvua	筝
qrv	整
qrvi	政
qrvii	丁
qrviuv	政
qrvivi	正 整
qs	恰
qsa	洽
qsaivo	洽
qsi	卡
qsia	髂
qsiaoo	髂
qsii	葜
qsiivv	葜
qsiu	掐
qsiui	拤
qsiuiv	拤
qsiuua	掐
qsivvi	卡
qso	袷
qsoaiv	袷
qsooiv	恰
qt	全
qta	劝
qtaa	绻
qtaaou	绻
qtaoau	劝
qtau	婘
qtauou	婘
qti	圈
qtia	蜷
qtiaa	𨟠
qtiaai	𨟠
qtiaou	圈 蜷
qtiav	畎
qtiavu	畎
qtii	荃
qtiiiv	荃
qtiiv	颧
qtiivu	颧
qtiivv	佺
qtio	铨
qtioiv	铨
qtivvi	全
qto	券
qtoa	诠
qtoaiv	诠
qtoo	悛
qtooao	悛
qtou	拳
qtouau	券
qtouiu	拳
qtov	痊
qtoviv	痊
qtu	泉
qtua	鳈
qtuaui	鳈
qtuiaa	泉
qtuv	筌
qtuviv	筌
qtv	权
qtva	辁
qtvaiv	辁
qtvaoo	权
qtvi	醛
qtviii	醛
qtvio	鬈
qtviou	鬈
qtvo	棬
qtvouv	棬
qtvu	犬
qtvuoo	犬
qtvv	瑔
qtvvui	瑔
qw	群
qwa	逡
qwaa	𬘯
qwaaov	𬘯
qwao	淳
qwaooa	逡
qwaovo	淳
qwavou	群
qwi	囷
qwiauv	囷
qwo	准
qwoa	裙
qwoaav	裙
qwoao	谆
qwoaov	谆
qwoo	窀
qwoova	窀
qwov	麇
qwovio	准
qwovo	这
qwovoa	这
qwovuv	麇
qwu	肫
qwuu	衠
qwuuuo	衠
qwuvai	肫
qwva	屯
qwvaia	屯
qx	强
qxa	戕
qxaiva	戕
qxau	嫱
qxauuo	嫱
qxavoi	强
qxi	抢
qxia	蜣
qxiaou	蜣
qxiav	戗
qxiava	戗
qxii	蔷
qxiia	蔃
qxiiav	蔃
qxiiuo	蔷
qxio	锵
qxioa	镪
qxioav	镪
qxioov	锵
qxiov	锖
qxiovv	锖
qxiuia	抢
qxo	呛
qxoa	襁
qxoaav	襁
qxoi	跄
qxoiaa	呛
qxoiia	跄
qxou	羌
qxoua	羟
qxouao	羟
qxoui	炝
qxouia	炝
qxouvv	羌
qxov	将
qxovua	将
qxu	腔
qxuooa	腔
qxv	枪
qxviaa	枪
qxvo	墙
qxvouo	墙
qxvu	樯
qxvuoo	樯
qxvv	玱
qxvvia	玱
qy	穷
qya	嬛
qyauia	嬛
qyi	茕
qyii	䓖
qyiiav	茕
qyiioo	䓖
qyo	穹
qyooau	穷
qyooav	穹
qyu	筇
qyuvvi	筇
qyv	琼
qyvi	邛
qyviai	邛
qyvii	蛩
qyviia	蛩
qyviio	銎
qyvvov	琼
qz	找
qza	召
qzaa	沼
qzaauo	沼
qzauoo	召
qzi	招
qzia	罩
qziaiv	罩
qzio	钊
qzioa	𬬿
qzioau	𬬿
qzioii	钊
qziuau	招
qziuva	找
qzo	照
qzoa	诏
qzoaa	肇
qzoaau	诏
qzoaav	肇
qzoi	昭
qzoiau	昭
qzoio	曌
qzoioo	照 曌
qzou	着
qzoua	啁
qzouav	啁
qzouia	着
qzouo	嘲
qzouoo	嘲
qzov	旐
qzovuv	旐
qzu	朝
qzua	𬶐
qzuauo	𬶐
qzuo	兆
qzuoau	兆
qzuouu	朝
qzuu	爪
qzuuio	爪
qzuv	笊
qzuvuu	笊
qzv	赵
qzvi	棹
qzvivo	棹
qzvouo	赵
r	人
rb	瑞
rba	汭
rbaiau	汭
rbi	锐
rbia	蚋
rbiaia	蚋
rbii	蕊
rbiii	芮
rbiiia	芮
rbiioa	蕊
rbiiv	蕤
rbiivu	蕤
rbioou	锐
rbiv	睿
rbivia	睿
rbv	枘
rbviau	枘
rbvvia	瑞
rd	肉
rda	柔
rdaovv	柔
rdi	揉
rdiaii	肉
rdiuao	揉
rdo	蹂
rdoiao	蹂
rdou	糅
rdouao	糅
rdv	鞣
rdva	𫐓
rdvaao	𫐓
rdviao	鞣
re	热
rei	惹
reii	若
reiioa	惹
reiivu	若
reiuoo	热
reo	喏
reoiiv	喏
rf	然
rfa	染
rfauvv	染
rfi	冉
rfia	蚺
rfiaa	䎃
rfiaao	䎃
rfiaia	蚺
rfiaiv	冉
rfii	苒
rfiiia	苒
rfo	燃
rfouua	燃
rfuaoo	然
rfv	髯
rfviia	髯
rj	如
rja	汝
rjaa	缛
rjaau	洳
rjaauv	汝 洳
rjaav	𦈡
rjaavo	𦈡
rjaavu	缛
rjai	孺
rjaivo	孺
rjau	嬬
rjauoo	如
rjauvo	嬬
rjav	濡
rjavoa	濡
rjavu	溽
rjavuv	溽
rji	儒
rjia	蠕
rjiavo	蠕
rjii	茹
rjiiau	茹
rjiiv	薷
rjiivo	薷
rjiivu	蓐
rjio	铷
rjioau	铷
rjivoa	儒
rjo	褥
rjoa	襦
rjoavo	襦
rjoavu	褥
rjov	嚅
rjovoa	嚅
rju	入
rjuo	乳
rjuoaa	乳
rjuoo	入
rjv	辱
rjvo	颥
rjvovu	颥
rjvuvi	辱
rk	日
rka	驲
rkaaoi	驲
rkoii	日
rl	若
rla	弱
rlau	婼
rlauii	婼
rlavav	弱
rli	偌
rlii	鄀
rliia	蒻
rliiai	鄀
rliiav	蒻
rliiiv	偌
rliiv	爇
rliivo	爇
rliivu	若
rlu	箬
rluvii	箬
rn	任
rna	忍
rnaa	纫
rnaaau	纫
rnaau	纴
rnaauv	纴
rnau	刃
rnauoa	忍
rnauoo	刃
rnauu	妊
rnauuv	妊
rni	仁
rnia	仞
rniauo	仞
rnii	人
rniii	荏
rniiiu	荏
rniiv	葚
rniivi	葚
rniuvi	任
rnivvv	仁
rno	认
rnoa	衽
rnoaa	讱
rnoaau	讱
rnoaii	认
rnoauv	衽
rnu	壬
rnua	饪
rnuauv	饪
rnuv	稔
rnuvio	稔
rnuviv	壬
rnv	韧
rnva	轫
rnvaau	轫
rnvvau	韧
rp	让
rpa	瀼
rpaa	𬙋
rpaaov	𬙋
rpaovo	瀼
rpi	攘
rpii	蘘
rpiiov	蘘
rpio	儴
rpiovo	儴
rpiuov	攘
rpo	嚷
rpoa	禳
rpoaiv	让
rpoaov	禳
rpoovo	嚷
rpov	瓤
rpovuu	瓤
rpu	穰
rpuvov	穰
rpv	壤
rpvoov	壤
rr	仍
rri	扔
rriauu	仍
rriuau	扔
rt	软
rta	阮
rtaivv	阮
rtau	媆
rtauvu	媆
rtv	堧
rtvaua	软
rtvovu	堧
rtvv	瓀
rtvvvo	瓀
rw	润
rwaoia	润
rwo	闰
rwoivv	闰
ry	容
rya	溶
ryaa	绒
ryaavv	绒
ryaooa	溶
ryi	荣
ryia	嵘
ryiai	蝾
ryiaii	嵘 蝾
ryii	蓉
ryiioo	蓉
ryiiv	茸
ryiivi	茸
ryiivv	荣
ryio	镕
ryiooo	镕
ryo	熔
ryoa	冗
ryoaua	冗
ryoouo	容
ryouoo	熔
ryua	狨
ryuavv	狨
ryv	融
ryvo	榕
ryvoia	融
ryvooa	榕
ryvv	戎
ryvvo	瑢
ryvvoo	瑢
ryvvua	戎
rz	绕
rza	娆
rzaava	绕
rzauva	娆
rzi	扰
rzii	荛
rziiva	荛
rziuvu	扰
rzu	饶
rzuava	饶
rzv	桡
rzvvau	桡
s	三
sb	随
sba	隋
sbaa	绥
sbaauo	绥
sbai	隧
sbaia	濉
sbaiav	濉
sbaiou	隧
sbaiv	祟
sbaivu	随 隋
sbaivv	祟
sbav	尿
sbavaa	尿
sbi	岁
sbia	髓
sbiai	睢
sbiaio	睢
sbiaua	岁
sbiav	眭
sbiavo	眭
sbiavu	髓
sbii	荽
sbiiuo	荽
sbio	𬭼
sbioou	𬭼
sbo	虽
sboa	谇
sboao	襚
sboaou	襚
sboaov	谇
sboiav	虽
sboo	邃
sboooa	邃
sbou	遂
sbouo	燧
sbouoa	遂
sbouou	燧
sbov	旞
sbovuv	旞
sbu	穗
sbuv	穟
sbuvou	穟
sbuvvi	穗
sbv	碎
sbva	𫟦
sbvaou	𫟦
sbvuov	碎
sbvv	璲
sbvvou	璲
sd	搜
sda	溲
sdauiv	溲
sdi	薮
sdia	瞍
sdiau	螋
sdiaui	瞍 螋
sdii	蒐
sdiiou	薮
sdiiui	蒐
sdio	锼
sdioui	锼
sdiu	擞
sdiuou	擞
sdiuui	搜
sdo	嗖
sdoo	嗾
sdoova	嗾
sdouiv	嗖
sdov	嗽
sdovia	嗽
sdovu	廋
sdovui	廋
sdu	馊
sdua	飕
sduaui	馊 飕
sdui	叟
sduiao	叟
sduu	艘
sduuui	艘
se	色
sea	涩
seaauo	涩
seau	㴔
seauaa	㴔
seav	洓
seavia	洓
sei	铯
seioua	铯
seo	塞
seoovo	塞
seu	啬
seuaai	色
seuoia	啬
seuv	穑
seuvuo	穑
sev	瑟
sevv	槭
sevvoa	瑟
sevvui	槭
sevvv	璱
sevvvv	璱
sf	散
sfa	叁
sfao	毵
sfaou	参
sfaouu	参
sfaouv	毵
sfaovv	叁
sfav	潵
sfavii	潵
sfi	伞
sfiouu	伞
sfo	糁
sfouao	糁
sfu	馓
sfuavi	馓
sfviuv	散
sfvvvv	三
sh	赛
shi	思
shiaoa	思
sho	塞
shoo	噻
shooao	赛
shoooa	噻
shoovo	塞
shu	腮
shua	鳃
shuaia	鳃
shuiav	腮
sj	苏
sja	肃
sjaa	骕
sjaaav	骕
sjaao	缩
sjaaoo	缩
sjao	溯
sjaouv	溯
sjav	涑
sjavia	涑
sjavu	鹔
sjavua	鹔
sjavvi	肃
sji	俗
sjii	蔌
sjiiau	苏
sjiivi	蔌
sjiuoi	俗
sjiv	僳
sjivia	僳
sjivv	傃
sjivvi	傃
sjo	诉
sjoa	谡
sjoaia	谡
sjoauu	诉
sjoi	蹜
sjoioo	蹜
sjoo	宿
sjooiv	宿
sjooo	窣
sjooov	窣
sjoov	愫
sjoovv	愫
sjou	塑
sjouvo	塑
sjov	嗉
sjovvi	嗉
sju	稣
sjua	夙
sjuauv	稣
sjuav	觫
sjuavi	𫗧 觫
sjuavu	夙
sjuv	簌
sjuvvi	簌
sjv	速
sjvi	粟
sjvioa	速
sjviou	粟
sjviu	酥
sjviuv	甦 酥
sjvv	素
sjvvaa	素
sk	四
ska	司
skaa	丝
skaai	驷
skaaia	缌 驷
skaao	涘
skaaou	涘
skaau	鸶
skaaua	鸶
skaav	汜
skaava	汜
skaavv	丝
skai	泗
skaiau	泗
skau	姒
skauao	姒
skav	巳
skavaa	巳
skavi	澌
skavii	澌
skavoo	司
ski	似
skia	思
skiaa	㟃
skiaav	㟃
skiai	蛳
skiaiu	蛳
skiao	俟
skiaoa	思
skiaoi	似
skiaou	俟
skiau	兕
skiaua	四 兕
skiav	伺
skiavo	伺
skiia	偲
skiiav	偲
skio	食
skioav	食
skioi	锶
skioia	锶
skiu	撕
skiuvi	撕
sko	嗣
skoa	祠
skoaa	祀
skoaaa	咝
skoaav	祠 祀
skoiav	嗣
skov	嘶
skovii	嘶
skovv	凘
skovvi	凘
sku	私
skua	饲
skuaav	饲
skuai	飔
skuaia	飔
skuu	虒
skuuiv	虒
skuv	笥
skuvao	私
skuvav	笥
skv	死
skvi	斯
skvia	肆
skviav	楒 肆
skviuu	斯
skvo	寺
skvovi	寺
skvu	厮
skvuua	死
skvuvi	厮
skvv	耜
skvva	漦
skvvaa	漦
skvvia	耜
sl	所
sla	缩
slaaoo	缩
slai	娑
slaiau	娑
slaii	挲
slaiiu	挲
slau	溹
slauoo	溹
sli	锁
slia	睃
sliaao	睃
slii	蓑
sliia	莎
sliiai	莎
sliii	葰
sliiia	葰
sliiov	蓑
slioio	锁
sliv	些
slivvv	些
slo	嗦
sloa	唆
sloaou	唆
sloi	唢
sloiou	唢
sloo	嗍
sloouv	嗍
slou	羧
slouao	羧
slouoo	嗦
slu	索
sluoaa	索
sluuuu	所
slv	梭
slva	桫
slvaiu	桫
slvaou	梭
slvv	琐
slvvio	琐
sn	森
snvvvv	森
sp	桑
spa	颡
spaovu	颡
spaovv	桑
spi	搡
spiuao	搡
spo	嗓
spoaoa	嗓
spu	丧
spuoau	丧
spv	磉
spvuao	磉
sr	僧
srioui	僧
ss	撒
ssa	洒
ssai	挲
ssaiiu	挲
ssav	潵
ssavia	洒
ssavii	潵
ssi	萨
ssiiai	萨
ssiuvi	撒
ssiv	仨
ssivvv	仨
sso	飒
ssovua	飒
ssu	脎
ssuuov	脎
ssv	卅
ssvi	靸
ssviua	靸
ssvuii	卅
st	算
sti	蒜
stiivv	蒜
stu	狻
stuaao	狻
stuvia	算
stv	酸
stviao	酸
sw	孙
swaiiu	孙
swi	损
swii	荪
swiiai	荪
swio	隼
swiouo	隼
swiuoa	损
swu	笋
swua	狲
swuaai	狲
swuai	飧
swuaio	飧
swuvav	笋
swv	榫
swviov	榫
sy	送
sya	淞
syau	娀
syauvv	娀
syavuo	淞
syi	耸
syia	嵩
syiaov	嵩
syiav	崧
syiavu	崧
syii	怂
syiioa	怂
syiiv	菘
syiivi	耸
syiivu	菘
syiu	㧐
syiuao	㧐
syo	宋
syoa	诵
syoaao	诵
syoau	讼
syoauo	讼
syoo	忪
syoouo	忪
syoov	悚
syoovi	悚
syoovv	宋
syouoa	送
syov	竦
syovv	凇
syovvi	竦
syovvu	凇
syu	颂
syuovu	颂
syv	松
syvuoa	松
sz	扫
sza	骚
szaa	缫
szaaaa	缫
szaaao	骚
szaao	缲
szaaoo	溞 缲
szau	嫂
szauui	嫂
szi	搔
sziuao	搔
sziuav	扫
szo	燥
szouoo	燥
szov	瘙
szovao	瘙
szu	臊
szuooo	臊
szv	埽
szvi	梢
szviou	梢
szvoav	埽
t	他
tb	推
tba	退
tbai	𬯎
tbaiia	𬯎
tbavoa	退
tbi	蜕
tbiaou	蜕
tbiuio	推
tbo	褪
tboaav	褪
tbou	煺
tbouav	煺
tbu	腿
tbuavv	腿
tbui	魋
tbuiio	魋
tbuv	颓
tbuvvu	颓
tbv	忒
tbvoao	忒
tc	条
tca	迢
tcai	粜
tcaiou	粜
tcau	嬥
tcauao	嬥
tcauoa	迢
tci	挑
tcia	眺
tciau	蜩
tciaua	蜩
tciauo	眺
tcii	苕
tciiau	苕
tciu	佻
tciuov	佻
tciuuo	挑
tciv	龆
tcivau	龆
tco	调
tcoa	祧
tcoaua	调
tcoauo	祧
tcoi	跳
tcoiuo	跳
tcoo	窕
tcoouo	窕
tcou	啁
tcouav	啁
tcu	笤
tcua	鲦
tcuaua	鲦
tcuavv	条
tcuu	朓
tcuuov	朓
tcuvau	笤
tcv	髫
tcviau	髫
td	头
tda	贴
tdaoiv	贴
tdi	偷
tdia	帖
tdiaiv	帖
tdiau	骰
tdiaua	骰
tdii	萜
tdiiia	萜
tdiivu	偷
tdio	铁
tdioo	钭
tdiooo	钭
tdiouv	铁
tdiu	投
tdiuua	投
tdoovu	头
tdu	透
tduvoa	透
tdv	餮
tdvuio	餮
te	特
tei	铽
teiovo	铽
teuo	螣
teuoia	螣
teuvvo	特
tev	忒
tevi	忑
tevio	慝
tevioa	忑 慝
tevoao	忒
tf	谈
tfa	弹
tfaa	滩
tfaaoi	滩
tfau	澹
tfauav	澹
tfav	潭
tfavia	潭
tfavou	弹
tfi	探
tfia	炭
tfiavu	炭
tfii	菼
tfiiou	菼
tfio	贪
tfioao	贪
tfioo	钽
tfiooi	钽
tfioou	锬
tfiou	倓
tfioui	倓
tfiov	镡
tfiovi	镡
tfiu	摊
tfiuao	摊
tfiuoa	探
tfiv	忐
tfivoa	忐
tfo	叹
tfoa	谭
tfoao	袒
tfoaoi	袒
tfoaoo	叹
tfoaou	谈
tfoavi	谭
tfoi	昙
tfoivv	昙
tfoo	啴
tfooo	惔
tfooou	惔
tfooui	啴
tfoov	宕
tfoovu	宕
tfou	郯
tfouai	郯
tfov	痰
tfova	瘫
tfovao	瘫
tfovou	痰
tfu	毯
tfuvou	毯
tfv	坦
tfvi	覃
tfvioi	覃
tfvo	坛
tfvooi	坦
tfvou	坍
tfvoua	坍
tfvov	檀
tfvovi	檀
tfvovv	坛
tfvu	碳
tfvuia	碳
tfvuv	磹
tfvuvi	磹
tfvv	榃
tfvvia	榃
tfvvo	璮
tfvvov	璮
tg	听
tga	汀
tgaa	𬘩
tgaauv	𬘩
tgao	渟
tgaovo	渟
tgau	婷
tgauov	婷
tgavii	汀
tgi	停
tgia	蜓
tgiau	䗴
tgiauv	蜓 䗴
tgiav	町
tgiavi	町
tgii	葶
tgiiov	葶
tgiiu	莛
tgiiuv	莛
tgio	铤
tgiouv	铤
tgiovo	停
tgiu	挺
tgiuuv	挺
tgiuv	侹
tgiuvi	侹
tgo	庭
tgou	烃
tgouao	烃
tgouu	烶
tgouuv	听 烶
tgov	亭
tgovuv	庭
tgovvi	亭
tgu	艇
tguuuv	艇
tguv	廷
tguvao	廷
tguvv	颋
tguvvu	颋
tgv	厅
tgvo	霆
tgvouv	霆
tgvov	圢
tgvovi	圢
tgvovv	桯
tgvu	梃
tgvuvi	厅 梃
tgvv	珽
tgvvuv	珽
th	太
tha	台
thaa	骀
thaaao	骀
thao	邰
thaoai	邰
thaoo	炱
thaooo	台
thaoou	炱
thav	汰
thavuo	汰
thi	抬
thii	苔
thiiao	苔
thiiv	薹
thiivo	薹
thio	钛
thiovu	钛
thiuao	抬
tho	跆
thoiao	跆
thov	呔
thovuo	呔
thu	胎
thua	鲐
thuaao	鲐
thuaoo	胎
thuv	肽
thuvuo	肽
thv	态
thvi	酞
thvivu	酞
thvuoa	态
thvuoo	太
thvv	泰
thvvaa	泰
tj	图
tja	涂
tjaa	𬳿
tjaaiv	𬳿
tjaivv	涂
tjav	屠
tjavuo	屠
tji	途
tjiaua	图
tjii	荼
tjiiiv	荼
tjiio	葖
tjiioo	葖
tjiiu	菟
tjiiua	菟
tjio	钍
tjiovo	钍
tjiv	凸
tjivia	凸
tjivoa	途
tjo	吐
tjoo	突
tjoovu	突
tjovoo	吐
tju	徒
tjua	兔
tjuaia	兔
tjuu	腯
tjuuuu	腯
tjuuvo	徒
tjuv	秃
tjuvi	稌
tjuviv	稌
tjuvua	秃
tjv	土
tjvi	酴
tjviiv	酴
tjviv	梌
tjvivv	梌
tjvo	堍
tjvoo	土
tjvoua	堍
tjvv	㻬
tjvvvo	㻬
tk	体
tka	涕
tkaa	缇
tkaao	绨
tkaaoi	𫘨 缇
tkaaou	绨
tkaoua	涕
tkau	媞
tkauoi	媞
tkav	屉
tkavvi	屉
tki	提
tkii	荑
tkiiv	俶
tkiiva	荑
tkiivv	俶
tkio	锑
tkioou	锑
tkiu	倜
tkiuav	倜
tkiuo	擿
tkiuoi	提
tkiuov	擿
tkiviu	体
tko	题
tkoa	裼
tkoao	禔
tkoaoi	禔 裼
tkoi	踢
tkoii	剔
tkoiii	剔
tkoio	蹄
tkoioi	踢
tkoiov	蹄
tkoivu	题
tkoo	啼
tkooo	惕
tkoooi	惕
tkooou	悌
tkoovo	啼
tkou	剃
tkouii	剃
tkouo	嚏
tkouoo	嚏
tkouu	鹈
tkouua	鹈
tkov	遆
tkovoa	遆
tku	逖
tkua	鳀
tkuaoa	逖
tkuaoi	鳀
tkuo	䏲
tkuoua	䏲
tkuu	䴘
tkuuua	䴘
tkv	替
tkva	棣
tkvavv	棣
tkvi	醍
tkvioi	醍
tkvo	梯
tkvoa	趯
tkvoao	趯
tkvoua	梯
tkvv	瑅
tkvvoi	替 瑅
tl	托
tla	驮
tlaa	驼
tlaaoo	驼
tlaavu	驮
tlai	陀
tlaioo	陀
tlao	沱
tlaooa	沱
tli	拖
tlii	萚
tliiiu	萚
tlio	铊
tlioo	佗
tliooa	佗
tliooo	铊
tliov	侂
tliovu	侂
tliu	拓
tliuuv	托 拖
tliuvu	拓
tlo	唾
tloi	跎
tloioo	跎
tloo	鼍
tloooi	鼍
tlouvi	唾
tlov	庹
tlovav	庹
tlu	脱
tlua	鸵
tluao	𬶍
tluaoo	鸵 𬶍
tlui	魄
tluiui	魄
tluo	妥
tluoau	妥
tluouo	脱
tluvi	箨
tluviu	箨
tlv	椭
tlvaiv	椭
tlvi	橐
tlvio	酡
tlvioo	酡
tlvivu	橐
tlvo	坨
tlvoo	柁
tlvooa	柁
tlvooo	坨
tlvou	圫
tlvouv	圫
tlvu	砣
tlvuoo	砣
tlvuu	柝
tlvuuv	柝
tm	天
tma	添
tmai	沺
tmaia	淟
tmaiav	沺 淟
tmao	湉
tmaooi	湉
tmavvu	添
tmi	田
tmia	畋
tmiau	盷
tmiaua	盷
tmiauv	畋
tmiavi	田
tmii	佃
tmiiav	佃
tmio	钿
tmioia	钿
tmiu	掭
tmiuvv	掭
tmo	恬
tmoi	阗
tmoii	晪
tmoiia	晪
tmoiuo	阗
tmoouv	恬
tmu	甜
tmui	腆
tmuiav	腆
tmuv	舔
tmuvvi	甜
tmuvvv	舔
tmv	填
tmvi	黇
tmviiv	黇
tmvouo	填
tmvu	殄
tmvuiu	殄
tmvv	忝
tmvviu	忝
tmvvu	瑱
tmvvuo	天 瑱
tp	唐
tpa	汤
tpaa	烫
tpaaou	烫
tpaauu	汤
tpaav	𬍡
tpaavv	𬍡
tpai	淌
tpaiou	淌
tpao	溏
tpaovu	溏
tpau	帑
tpauia	帑
tpi	堂
tpia	螳
tpiaio	螳
tpiao	螗
tpiaov	螗
tpii	倘
tpiio	傥
tpiiou	倘 傥
tpio	棠
tpioa	铴
tpioaa	铴
tpioai	䣘
tpioi	镗
tpioio	镋 铛 镗
tpiovo	堂
tpiovv	棠
tpiu	搪
tpiuov	搪
tpo	糖
tpoi	嘡
tpoii	蹚
tpoiio	蹚
tpoiou	嘡
tpoo	惝
tpooio	惝
tpou	羰
tpouia	羰
tpouov	糖
tpov	鄌
tpovai	鄌
tpovav	唐
tpu	躺
tpua	饧
tpuaau	饧
tpui	膛
tpuiio	躺
tpuiou	膛
tpv	塘
tpvio	樘
tpviou	樘
tpvo	趟
tpvoi	埫
tpvoio	趟 埫
tpvoov	塘
tpvv	瑭
tpvvi	耥
tpvvio	耥
tpvvov	瑭
tr	腾
tri	藤
triiuo	藤
tro	疼
trou	誊
troua	熥
trouao	熥
trouov	誊
trovua	疼
tru	滕
truo	螣
truoa	縢
truoaa	腾 滕 縢
truoia	螣
truou	䲢
truoua	䲢
ts	她
tsa	沓
tsai	漯
tsaiav	漯
tsaii	溚
tsaiii	溚
tsao	溻
tsaoia	溻
tsaoii	沓
tsauai	她
tsi	挞
tsiaia	他
tsio	铊
tsiooo	铊
tsiu	拓
tsiuvu	挞 拓
tso	它
tsoao	褟
tsoaoi	褟
tsoi	踏
tsoiao	踏
tsoii	嗒
tsoiii	嗒
tsoio	蹋
tsoioa	遢
tsoioi	阘 蹋
tsoiu	趿
tsoiua	趿
tsoiv	闼
tsoivu	闼
tsooua	它
tsu	獭
tsua	鳎
tsuaoi	鳎
tsuavi	獭
tsv	塔
tsvi	鞳
tsviii	鞳
tsvo	塌
tsvoi	榻
tsvoia	榻
tsvoii	塔
tsvooi	塌
tsvu	鿎
tsvuvu	鿎
tt	团
tta	湍
ttaa	彖
ttaavu	彖
ttaiai	湍
tti	抟
ttia	疃
ttiaov	疃
ttiavi	团
ttiu	揣
ttiuia	揣
ttiuvv	抟
tto	煓
ttouia	煓
ttu	猯
ttuaia	猯
tw	吞
twa	臀
twav	沌
twavai	沌
twavuu	臀
twi	囤
twiava	囤
two	暾
twoa	褪
twoaav	褪
twoiov	暾
twoo	忳
twoova	忳
twou	焞
twouov	焞
twu	豚
twua	饨
twuav	鲀
twuava	饨 鲀
twuvua	豚
twv	屯
twvaia	屯
twvo	坉
twvoa	忒
twvoao	忒
twvova	坉
twvvoo	吞
ty	同
tya	通
tyaa	统
tyaaov	统
tyai	洞
tyaiav	洞
tyao	潼
tyaooa	通
tyaovo	潼
tyau	㛚
tyauao	㛚
tyi	铜
tyia	瞳
tyiai	峒
tyiaia	峒
tyiaov	瞳
tyiau	峂
tyiaua	峂
tyiavo	同
tyii	茼
tyiia	侗
tyiiav	侗
tyiiia	茼
tyio	僮
tyioia	铜
tyiovo	僮
tyiu	捅
tyiua	佟
tyiuao	捅 佟
tyiv	仝
tyiviv	仝
tyo	痛
tyoa	嗵
tyoai	𫍣
tyoaia	𫍣
tyoaoi	嗵
tyoi	哃
tyoiav	哃
tyoio	曈
tyoiov	曈
tyoo	恸
tyooi	恫
tyooia	恫
tyoovv	恸
tyou	烔
tyouia	烔
tyov	童
tyova	𦒍
tyovao	痛 𦒍
tyovia	童
tyu	筒
tyua	彤
tyuai	鲖
tyuaia	鲖
tyuauu	彤
tyuv	穜
tyuvia	筒
tyuvov	穜
tyv	桶
tyvaoi	桶
tyvi	桐
tyviav	桐
tyvii	酮
tyviia	酮
tyvo	垌
tyvoia	垌
tyvov	橦
tyvovo	橦
tyvu	砼
tyvuiv	砼
tz	陶
tza	淘
tzaa	绦
tzaau	绹
tzaaua	𫘦 绦 绹
tzaiua	陶
tzau	滔
tzauau	淘
tzauo	洮
tzauoo	滔
tzauov	洮
tzav	涛
tzavi	弢
tzavia	弢
tzavvv	涛
tzi	掏
tzii	萄
tziiua	萄
tziuua	掏
tzo	讨
tzoa	叨
tzoauu	叨
tzoavi	讨
tzoo	慆
tzoouo	慆
tzou	啕
tzouau	啕
tzov	饕
tzovio	饕
tzu	逃
tzuo	鼗
tzuooa	逃
tzuovo	鼗
tzv	套
tzvu	桃
tzvuov	桃
tzvuvi	套
tzvv	焘
tzvvoo	焘
tzvvu	韬
tzvvuo	韬
tzvvv	梼
tzvvvv	梼
w	我
wb	吹
wba	陲
wbaiuv	陲
wbi	锤
wbia	圌
wbiaia	圌
wbiouv	锤
wbiu	捶
wbiuuv	捶
wbiuv	倕
wbiuvi	倕
wbo	炊
wbouai	吹
wbouua	炊
wbu	垂
wbuviv	垂
wbv	槌
wbvi	椎
wbviov	椎
wbvu	棰
wbvuia	槌
wbvuvi	棰
wd	抽
wda	丑
wdaa	绸
wdaaua	绸
wdaivv	丑
wdi	仇
wdia	瞅
wdiauv	瞅
wdiav	畴
wdiavo	畤
wdiavv	帱 畴
wdio	雠
wdiooa	雠
wdiou	犨
wdiouv	犨
wdiuaa	仇
wdiuia	抽
wdiv	俦
wdiva	侴
wdivai	侴
wdivvv	俦
wdo	踌
wdoivv	踌
wdoo	惆
wdooua	惆
wdov	瘳
wdovao	瘳
wdu	愁
wdui	臭
wduivu	臭
wduv	筹
wduvoa	愁
wduvu	稠
wduvua	稠
wduvvv	筹
wdv	酬
wdva	杻
wdvaiv	杻
wdviou	酬
wdvu	椆
wdvuav	椆
we	车
wea	澈
weaova	澈
weav	尺
weavuo	尺
wei	撤
weiu	扯
weiuiv	扯
weiuov	撤
weo	㬚
weoiov	㬚
weu	彻
weuuva	彻
weuv	掣
weuviu	掣
wev	坼
wevavi	车
wevouu	坼
wevu	砗
wevuva	砗
wf	完
wfa	湾
wfaa	绾
wfaao	𬘫
wfaaoo	绾 𬘫
wfaau	纨
wfaaua	纨
wfao	涴
wfaooa	涴
wfaovi	湾
wfau	婉
wfauo	婠
wfauoo	婉 婠
wfauu	娩
wfauua	娩
wfauv	妧
wfauvv	妧
wfav	𬇕
wfavau	𬇕
wfi	挽
wfia	蜿
wfiao	畹
wfiaoo	蜿 畹
wfii	芄
wfiio	菀
wfiioi	蔓
wfiioo	莞 菀
wfiiua	芄
wfiuua	挽
wfo	晚
wfoiua	晚
wfoo	宛
wfooi	剜
wfooii	剜
wfooo	惋
wfoooo	惋
wfooua	宛
wfoovv	完
wfou	烷
wfouoo	烷
wfov	弯
wfovav	弯
wfu	丸
wfuaoo	丸
wfui	皖
wfuioo	皖
wfuo	腕
wfuoo	脘
wfuooa	腕 脘
wfv	万
wfvauu	万
wfvo	豌
wfvoo	塆
wfvooa	椀
wfvooo	豌
wfvoov	塆
wfvu	碗
wfvuoo	碗
wfvv	玩
wfvvo	琬
wfvvoo	琬
wfvvv	顽
wfvvvu	顽
wfvvvv	玩
wg	揣
wgi	搋
wgiuia	揣
wgiuuu	搋
wgo	踹
wgoa	啜
wgoaoa	啜
wgoiia	踹
wgoo	嘬
wgooiv	嘬
wh	外
whi	崴
whiavu	崴
whuaio	外
whv	歪
whvuvi	歪
wj	无
wja	屋
wjaa	毋
wjaauv	毋
wjao	骛
wjaoa	婺
wjaoaa	骛
wjaoau	婺
wjaou	鹜
wjaoua	鹜
wjau	妩
wjaui	鋈
wjauio	鋈
wjauvv	妩
wjav	污
wjavi	浯
wjavia	浯
wjavu	洿
wjavuo	洿
wjavv	𣲘
wjavva	屋 污
wjavvu	𣲘
wji	伍
wjia	蜈
wjiaov	蜈
wjiav	屼
wjiavi	峿
wjiavu	屼
wjii	芜
wjiiu	芴
wjiiua	芴
wjiivv	芜
wjio	钨
wjioua	钨
wjiov	铻
wjiovi	铻
wjiu	侮
wjiuv	捂
wjiuva	侮
wjiuvi	捂
wjiuvu	仵
wjivia	伍
wjo	误
wjoa	诬
wjoaov	误
wjoav	喔
wjoavi	诬
wjoavu	喔
wjoi	晤
wjoiu	旿
wjoiuv	旿
wjoivi	晤
wjoo	悟
wjooa	寤
wjooai	寤
wjoou	忤
wjoouv	忤
wjoov	怃
wjoovi	悟
wjoovv	怃
wjou	呜
wjouaa	呜
wjouv	焐
wjouvi	焐
wjov	吴
wjova	亡
wjovaa	亡
wjovi	唔
wjovia	唔
wjovio	於
wjovv	庑
wjovvi	痦
wjovvu	吴
wjovvv	庑
wju	物
wjua	务
wjuaa	乌
wjuaai	邬
wjuaau	务
wjuaav	乌
wjuau	勿
wjuauu	勿
wjui	鼯
wjuivi	鼯
wjuv	舞
wjuvo	迕
wjuvoa	迕
wjuvu	午
wjuvua	物 舞
wjuvuo	午
wjuvv	牾
wjuvvi	牾
wjv	五
wjvi	吾
wjvia	郚
wjviai	郚
wjviav	五
wjvii	巫
wjviii	巫
wjvio	恶
wjvioa	恶
wjvioo	吾
wjviu	鹀
wjviua	鹀
wjviv	靰
wjvivu	靰
wjvo	雾
wjvou	坞
wjvoua	雾 坞
wjvov	圬
wjvovv	圬
wjvu	兀
wjvua	戊
wjvuaa	兀
wjvuau	戊
wjvv	武
wjvvi	梧
wjvvia	梧
wjvviv	武
wjvvu	鹉
wjvvua	杌 无 鹉
wjvvv	珸
wjvvvi	珸
wjvvvv	珷
wk	吃
wka	迟
wkaa	池
wkaaa	驰
wkaaai	驰
wkaaia	池
wkaau	𫄨
wkaauo	𫄨
wkai	蚩
wkaiia	蚩
wkau	媸
wkauai	媸
wkav	尺
wkava	弛
wkavai	弛
wkavoa	迟
wkavuo	尺
wki	持
wkia	螭
wkiaa	眙
wkiaao	眙
wkiao	佁
wkiaoo	佁
wkiaov	螭
wkiau	眵
wkiaua	眵
wkii	茌
wkiiiv	茌
wkiu	侈
wkiua	傺
wkiuao	侈 傺
wkiuo	摛
wkiuov	摛
wkiuvo	持
wkiv	齿
wkivia	齿
wko	痴
wkoa	嗤
wkoaii	嗤
wkoau	褫
wkoauu	褫
wkoi	匙
wkoiu	踟
wkoiua	匙
wkoiuv	踟
wkou	叱
wkouaa	叱
wkouo	炽
wkouou	炽
wkouva	吃
wkov	哧
wkovo	啻
wkovoo	啻
wkovou	哧
wkovuv	痴
wkovv	瘛
wkovva	痓
wkovvv	瘛
wku	斥
wkua	饬
wkuau	鸱
wkuaua	鸱
wkuauv	饬
wkui	魑
wkuiov	魑
wkuo	翅
wkuoa	郗
wkuoai	郗
wkuoao	翅
wkuov	瓻
wkuova	瓻
wkuu	彳
wkuuii	彳
wkuuv	胣
wkuuva	胣
wkuuvi	斥
wkuv	笞
wkuvao	笞
wkuvu	篪
wkuvuu	篪
wkv	赤
wkvi	耻
wkviiv	耻
wkviu	敕
wkviuv	敕
wkvo	豉
wkvoa	墀
wkvoav	墀
wkvou	坻
wkvoua	坻
wkvoui	赤
wkvouo	豉
wkvv	漦
wkvvaa	漦
wl	握
wla	沃
wlaa	绰
wlaaiv	绰
wlaav	渥
wlaavu	渥
wlai	淖
wlaivo	淖
wlao	戳
wlaoi	涡
wlaoia	涡
wlaoo	涴
wlaooa	涴
wlaova	戳
wlaui	婼
wlauii	婼
wlauvu	沃
wli	倭
wlia	蜗
wliaa	幄
wliaav	幄
wliaoi	蜗
wliav	偓
wliavu	偓
wlii	莴
wliioi	莴
wliu	挝
wliuav	握
wliuvi	倭 挝
wliv	龌
wlivav	龌
wlivo	龊
wlivoa	逴
wlivoi	龊
wlo	窝
wloa	喔
wloao	啜
wloaoa	啜
wloavu	喔
wloi	踔
wloiiv	踔
wloiu	踒
wloiuv	踒
wloo	惙
wlooao	惙
wloooi	窝
wlu	斡
wluoio	斡
wluv	肟
wluviv	我
wluvva	肟
wlv	卧
wlva	辍
wlvaao	辍
wlviio	卧
wlvu	硪
wlvuuv	硪
wm	床
wmi	创
wmia	幢
wmiaii	创
wmiaov	幢
wmo	窗
wmoi	闯
wmoiaa	闯
wmoo	怆
wmooia	怆
wmooui	窗
wmoov	噇
wmoovo	噇
wmov	疮
wmovia	疮
wmovvv	床
wn	问
wna	温
wnaa	纹
wnaao	𫘜
wnaaov	纹 𫘜
wnao	汶
wnaoii	温
wnaovu	汶
wni	蚊
wniaov	蚊
wnii	芠
wniia	蕰
wniiao	蕰
wniiov	芠
wno	文
wnoi	闻
wnoioo	问
wnoiu	阌
wnoiuo	阌
wnoivi	闻
wnou	吻
wnouau	吻
wnouo	炆
wnouov	炆
wnov	紊
wnovaa	紊
wnovo	瘟
wnovoi	瘟
wnovuo	文
wnu	稳
wnua	刎
wnuaii	刎
wnuao	鳁
wnuaoi	鳁
wnui	璺
wnuivv	璺
wnuvua	稳
wnv	雯
wnva	辒
wnvaoi	辒
wnvo	榅
wnvoii	榅
wnvoov	雯
wnvv	玟
wnvvo	韫
wnvvoi	韫
wnvvov	玟
wp	望
wpa	汪
wpavvi	汪
wpi	网
wpia	罔
wpiaou	罔
wpiauo	网
wpo	忘
wpoi	旺
wpoivv	旺
wpoo	惘
wpooia	惘
wpov	亡
wpova	妄
wpovaa	亡
wpovau	妄
wpovoa	忘
wpovvv	望
wpu	往
wpui	魍
wpuiia	魍
wpuuov	往
wpv	王
wpva	辋
wpvaia	辋
wpvu	尪
wpvua	尢
wpvuaa	尢
wpvuvv	尪
wpvv	枉
wpvviv	王
wpvvvi	枉
wqo	欻
wqouua	欻
wr	翁
wra	滃
wrauoa	滃
wri	蓊
wrii	蕹
wriiov	蕹
wriiuo	蓊
wrio	𬭩
wriouo	𬭩
wro	嗡
wrouoa	嗡
wru	瓮
wruo	鹟
wruoao	翁
wruoua	鹟
wruova	瓮
ws	差
wsa	娃
wsaa	汊
wsaaoo	汊
wsao	叉
wsaooo	叉
wsau	娲
wsauo	姹
wsauoi	娲
wsauoo	婠 姹
wsauvo	娃
wsav	洼
wsavov	洼
wsi	插
wsia	蛙
wsiai	凹
wsiaia	凹
wsiau	畖
wsiauu	畖
wsiav	嵖
wsiavo	蛙 嵖
wsii	茶
wsiii	苴
wsiiia	苴
wsiiiv	茶
wsiiv	茬
wsiivu	茬
wsio	锸
wsioo	镲
wsiooa	侘
wsiooo	镲
wsiouv	锸
wsiu	挖
wsiui	搽
wsiuii	搽
wsiuoo	挖
wsiuuv	插
wsiv	佤
wsivaa	佤
wso	察
wsoa	袜
wsoaa	衩
wsoaao	衩
wsoao	诧
wsoaoo	诧
wsoavv	袜
wsoi	蹅
wsoivo	蹅
wsoo	嚓
wsoooa	嚓
wsoou	窊
wsooua	察
wsoouu	窊
wsou	𥻗
wsouvi	差
wsouvo	𥻗
wsov	哇
wsovo	喳
wsovoi	喳
wsovov	哇
wsu	刹
wsua	馇
wsuav	猹
wsuavo	馇 猹
wsuo	岔
wsuoi	腽
wsuoia	岔
wsuoii	刹 腽
wsv	查
wsva	瓦
wsvaao	瓦
wsvao	杈
wsvaoo	杈
wsvo	檫
wsvoiv	查
wsvoo	垞
wsvooa	檫
wsvooo	垞
wsvou	槎
wsvouu	坬
wsvouv	槎
wsvu	碴
wsvuvo	碴
wsvv	楂
wsvvoi	楂
wt	穿
wti	传
wtia	串
wtiai	圌
wtiaia	圌
wtiao	遄
wtiaoa	遄
wtiavi	串
wtio	钏
wtioui	钏
wtivva	传
wto	喘
wtoiai	喘
wtoova	穿
wtu	船
wtua	舛
wtuava	舛
wtui	川
wtuiii	川
wtuuua	船
wtuv	氚
wtuvui	氚
wtv	椽
wtvaav	椽
wtvo	堾
wtvovv	堾
ww	为
wwa	维
wwaa	纬
wwaaa	潍
wwaaav	潍
wwaaio	维
wwaavv	纬
wwai	卫
wwaia	渭
wwaiai	溦
wwaiav	涠 渭
wwaii	隈
wwaiia	隈
wwaiu	隗
wwaiui	隗
wwaivv	卫
wwao	沩
wwaoua	沩
wwau	娓
wwaua	洈
wwauav	娓 洈
wwauo	妫
wwauou	妫
wwav	尾
wwavi	螱
wwavia	螱
wwavo	慰
wwavoa	慰
wwavu	洧
wwavuu	洧
wwavuv	尾
wwavv	尉
wwavva	𣲗
wwavvi	尉
wwi	位
wwia	围
wwiai	帷
wwiaio	帷
wwiao	遗
wwiaoa	遗
wwiau	胃
wwiaua	峗
wwiaui	嵬
wwiauu	胃
wwiauv	巍
wwiav	畏
wwiava	畏
wwiavu	崴
wwiavv	帏 围
wwii	萎
wwiia	偎
wwiiav	蔚 偎
wwiio	𫇭
wwiiou	𫇭
wwiiu	薇
wwiiuu	薇
wwiiuv	萎
wwiiv	苇
wwiivo	薳
wwiivu	葳
wwiivv	苇
wwio	伪
wwioua	伪
wwiov	𬭬
wwiovo	位
wwiovv	𬭬
wwiu	㧑
wwiuou	㧑
wwiv	伟
wwivva	伟
wwo	味
wwoa	谓
wwoaia	谓
wwoau	诿
wwoauv	诿
wwoi	唯
wwoia	喂
wwoiav	喂
wwoiov	唯
wwoiv	闱
wwoivv	韪 𬀩 闱
wwoo	惟
wwooio	惟
wwou	煨
wwouao	为
wwoui	煟
wwouia	煨 煟
wwouv	炜
wwouvv	炜
wwov	痿
wwovu	亹
wwovui	廆 亹
wwovuv	痿
wwovvi	味
wwu	委
wwua	危
wwuaa	鳚
wwuaaa	危
wwuaav	鳚
wwuai	猥
wwuaia	猬 鳂 猥
wwuau	𬶏
wwuaua	𬶏
wwuav	鲔
wwuavu	𬱟 鲔
wwuu	微
wwuua	艉
wwuuav	艉
wwuuia	微
wwuv	魏
wwuvau	委
wwuvo	逶
wwuvoa	逶
wwuvui	魏
wwv	未
wwvo	圩
wwvoa	霨
wwvoav	霨
wwvovv	圩
wwvu	威
wwvua	桅
wwvuau	威
wwvuav	桅
wwvui	硙
wwvuia	碨 硙
wwvuu	硊
wwvuua	硊
wwvv	违
wwvva	韦
wwvvai	韦
wwvvi	琟
wwvvio	琟
wwvviu	未
wwvvoa	违
wwvvv	玮
wwvvvv	玮
wx	床
wxi	创
wxia	幢
wxiaii	创
wxiaov	幢
wxo	窗
wxoi	闯
wxoiaa	闯
wxoo	怆
wxooia	怆
wxooui	窗
wxoov	噇
wxoovo	噇
wxov	疮
wxovia	疮
wxovvv	床
wy	冲
wya	涌
wyaaoi	涌
wyai	漴
wyaiai	漴
wyao	翀
wyaoia	翀
wyaov	㳘
wyaova	㳘
wyi	虫
wyia	崇
wyiaoo	崇
wyiavi	虫
wyii	茺
wyiiov	茺
wyio	铳
wyioov	铳
wyiu	摏
wyiuvv	摏
wyo	充
wyoo	宠
wyooi	忡
wyooia	忡
wyooo	憧
wyooov	憧
wyoovu	宠
wyovia	冲
wyovua	充
wyu	重
wyuu	艟
wyuuov	艟
wyuv	种
wyuvia	重 种
wyv	舂
wyvo	埫
wyvoio	埫
wyvv	珫
wyvvov	珫
wyvvui	舂
wz	超
wza	潮
wzaa	巢
wzaai	绰
wzaaia	巢
wzaaii	剿
wzaaiv	绰
wzauoo	潮
wzav	弨
wzavau	弨
wzi	抄
wzio	钞
wzioiu	钞
wziuiu	抄
wzo	炒
wzoi	吵
wzoiu	晁
wzoiuo	吵 晁
wzoo	怊
wzooau	怊
wzou	嘲
wzoui	焯
wzouiu	炒
wzouiv	焯
wzouoo	嘲
wzu	朝
wzuouu	朝
wzv	耖
wzvoau	超
wzvviu	耖
x	而
xb	新
xbi	信
xbii	薪
xbiio	芯
xbiioa	芯
xbiiov	莘 薪
xbio	锌
xbioa	伈
xbioao	伈
xbioi	鑫
xbioio	鑫
xbioov	锌
xbiov	镡
xbiovi	镡
xbiovv	信
xbo	心
xboa	䜣
xboaoo	心
xboauu	䜣
xboi	昕
xboiuu	昕
xboo	忻
xboouu	忻
xbou	炘
xbouuu	炘
xbov	辛
xbovi	𫷷
xbovio	𫷷
xbovu	歆
xbovua	歆
xbovuo	辛
xbovuu	新
xbu	欣
xbui	衅
xbuiou	衅
xbuiu	囟
xbuiuo	囟
xbuuua	欣
xbv	馨
xbvouv	馨
xc	小
xca	消
xcaa	骁
xcaai	绡
xcaaio	绡
xcaava	骁
xcai	潇
xcaiia	潇
xcaiou	消
xcao	洨
xcaov	滧
xcaovu	洨 滧
xcau	淆
xcauo	姣
xcauov	涍 淆 姣
xci	销
xcia	崤
xciai	蛸
xciaii	蟏
xciaio	蛸
xciauo	崤
xcii	萧
xciiav	萧
xciiu	翛
xciiua	翛
xcio	肖
xcioi	削
xcioii	削
xcioio	销
xcioo	逍
xciooa	逍
xciouu	肖
xciuoo	小
xco	效
xcoa	啸
xcoau	𫍲
xcoaui	𫍲
xcoavv	啸
xcoi	晓
xcoiva	晓
xcoo	宵
xcooio	宵
xcooo	恔
xcooov	恔
xcoouv	敩
xcoov	嚣
xcoovu	嚣
xcou	哮
xcouov	哮
xcov	哓
xcovau	哓
xcovu	鸮
xcovua	鸮
xcovuv	效
xcu	笑
xcua	枭
xcuai	虓
xcuaiv	猇 虓
xcuavv	枭
xcui	魈
xcuiio	魈
xcuiu	皛
xcuiui	皛
xcuo	孝
xcuoai	孝
xcuv	箫
xcuvav	箫
xcuvi	筱
xcuvii	筱
xcuvuv	笑
xcv	校
xcvo	霄
xcvoio	霄
xcvov	枵
xcvova	枵
xcvovu	校
xcvu	硝
xcvuio	硝
xd	些
xda	泄
xdaa	缬
xdaav	绁
xdaavi	绁
xdaavo	缬
xdai	瀣
xdaia	𠙶
xdaiai	𠙶
xdaivu	瀣
xdao	泻
xdaoav	泻
xdau	勰
xdaua	澥
xdauau	澥
xdauia	勰
xdav	屑
xdavi	渫
xdavii	泄 渫
xdavio	屑
xdavu	沤
xdavuo	沤
xdi	斜
xdia	蝎
xdiaoi	蝎
xdii	偶
xdiiav	偶
xdiiu	薢
xdiiua	薢
xdiiv	藕
xdiivu	薤
xdiivv	藕
xdiu	携
xdiuio	携
xdiuv	挟
xdiuvo	撷 挟
xdiuvv	揳
xdiv	偕
xdivau	偕
xdivi	𬹼
xdiviu	𬹼
xdivoo	斜
xdivv	偰
xdivvo	㙦
xdivvv	些 偰
xdo	写
xdoa	谢
xdoaui	谢
xdoav	谐
xdoava	写 谐
xdoavu	讴
xdoi	歇
xdoio	躞
xdoiov	躞
xdoiua	歇
xdoo	懈
xdooua	懈
xdoov	怄
xdoovu	怄
xdou	叶
xdouoo	叶
xdouv	吽
xdouvu	𬉼
xdouvv	吽
xdov	呕
xdova	燮
xdovao	燮
xdovi	亵
xdoviu	亵
xdovu	廨
xdovua	廨
xdovuo	呕
xdu	协
xdua	胁
xduaa	解
xduaau	解
xduai	蟹
xduaia	蟹
xduao	邂
xduaoa	邂
xduau	獬
xduaua	獬
xduauo	胁
xduav	鲑
xduavo	鲑
xdui	血
xduiai	血
xduoau	协
xduv	卸
xduvai	卸
xdv	欧
xdva	邪
xdvaai	邪
xdvav	榍
xdvavu	榍
xdvi	鞋
xdvivo	鞋
xdvo	颉
xdvov	𫭟
xdvovu	颉 𫭟
xdvu	殴
xdvui	榭
xdvuia	榭
xdvuo	区
xdvuoa	区
xdvuu	鸥
xdvuua	欧 殴 鸥
xdvuv	瓯
xdvuva	瓯
xdvv	械
xdvva	絜
xdvvaa	絜
xdvvi	耦
xdvvia	耦
xdvvo	𤫉
xdvvov	𤫉
xdvvv	楔
xdvvvu	契 械
xdvvvv	楔
xe	额
xea	阿
xeaivo	阿
xeau	娥
xeaua	婀
xeauai	婀
xeaui	姶
xeauiv	姶
xeauuv	娥
xeauv	涐
xeauvi	涐
xeav	屙
xeavai	屙
xei	俄
xeia	蛾
xeiao	崿
xeiaoo	崿
xeiau	峨
xeiauv	蛾 峨
xeii	萼
xeiioo	萼
xeiiu	莪
xeiiuv	莪
xeiiv	苊
xeiivu	苊
xeio	锷
xeiooo	锷
xeiou	锇
xeiouv	锇
xeiu	扼
xeiuvi	俄
xeiuvu	扼
xeo	呃
xeoa	讹
xeoaiu	讹
xeoao	谔
xeoaoo	谔
xeoi	遏
xeoio	阏
xeoioa	遏
xeoiov	阏
xeoo	愕
xeooa	鄂
xeooai	鄂
xeoooo	愕
xeoou	鹗
xeooua	鹗
xeoov	颚
xeoovu	额 颚
xeou	哦
xeouvi	哦
xeov	𫫇
xeovii	𫫇
xeovua	呃
xeu	饿
xeua	鳄
xeuaoo	鳄
xeuauv	饿
xeuo	腭
xeuoov	腭
xeuv	鹅
xeuvua	鹅
xev	恶
xeva	轭
xevavu	轭
xevi	噩
xevioa	恶
xevioo	噩
xeviv	垩
xevivo	垩
xevo	堨
xevooi	堨
xevu	厄
xevuaa	厄
xevuo	𥔲
xevuoo	𥔲
xf	安
xfi	按
xfia	岸
xfiao	黯
xfiaov	黯
xfiavu	岸
xfio	铵
xfioi	盦
xfioia	盦
xfiooo	铵
xfiuoo	按
xfiv	俺
xfivuo	俺
xfo	案
xfoa	谙
xfoaov	谙
xfoi	暗
xfoiov	暗
xfooau	安
xfoovv	案
xfov	庵
xfovu	唵
xfovuo	唵
xfovuu	广
xfovvu	庵
xfu	氨
xfua	犴
xfuao	𩽾
xfuaoo	𩽾
xfuavv	犴
xfuo	胺
xfuooa	胺
xfuvoo	氨
xfv	鞍
xfvioo	鞍
xfvo	桉
xfvoo	垵
xfvooa	桉
xfvooo	垵
xfvov	埯
xfvovu	埯
xfvu	鹌
xfvuu	厂
xfvuua	鹌
xg	行
xga	姓
xgaa	骍
xgaaov	骍
xgai	陉
xgaiao	陉
xgau	婞
xgaua	𫰛
xgauao	𫰛
xgauuv	姓
xgauvo	婞
xgi	省
xgii	荥
xgiiaa	荥
xgiiu	荇
xgiiuu	荇
xgio	铏
xgiov	钘
xgiovv	铏 钘
xgiu	擤
xgiuia	省
xgiuui	擤
xgo	性
xgoi	星
xgoiuv	星
xgoo	兴
xgooo	惺
xgoooi	惺
xgoouo	兴
xgoouv	性
xgoov	悻
xgoovo	悻
xgou	煋
xgouoi	煋
xgu	腥
xgua	猩
xguaa	饧
xguaau	饧
xguaoi	猩
xguoiu	腥
xguuvv	行
xgv	形
xgvi	醒
xgvioi	醒
xgvo	幸
xgvoo	杏
xgvoou	幸
xgvu	硎
xgvuvv	硎
xgvv	型
xgvva	邢
xgvvai	邢
xgvvi	刑
xgvvii	刑
xgvvo	瑆
xgvvoi	瑆
xgvvuu	形
xgvvvo	型
xh	学
xha	隘
xhai	𬮿
xhaiia	𬮿
xhaiou	隘
xhao	欸
xhaoua	欸
xhau	嫒
xhauuo	嫒
xhi	艾
xhii	薛
xhiio	蔼
xhiioa	蔼
xhiioo	茓
xhiiui	薛
xhiiuo	艾
xhio	削
xhioii	削
xhioo	锿
xhioov	锿
xhiu	挨
xhiuao	挨
xhiuo	踅
xhiuoi	踅
xho	哀
xhoa	唉
xhoai	谑
xhoaiv	谑
xhoaou	唉
xhoi	哎
xhoiiu	哎
xhoiu	暧
xhoiuo	暧
xhoiv	噱
xhoiva	噱
xhoo	穴
xhooai	学
xhooi	峃
xhooia	峃
xhoou	嗌
xhoouo	穴
xhoouv	敩 嗌
xhou	嗳
xhouoo	嗳
xhov	癌
xhovoo	癌
xhovou	哀
xhu	爱
xhua	鳕
xhuavo	鳕
xhui	血
xhuiai	血
xhuii	皑
xhuiia	皑
xhuovu	爱
xhuv	矮
xhuvuv	矮
xhv	雪
xhvi	靴
xhviiu	靴
xhvo	埃
xhvoa	毐
xhvoaa	毐
xhvoao	埃
xhvoav	雪
xhvoo	霭
xhvooa	霭
xhvu	碍
xhvui	砹
xhvuii	砹
xhvuoi	碍
xhvv	瑷
xhvvu	叆
xhvvuo	瑷 叆
xj	二
xja	洱
xjai	陑
xjaivu	陑
xjavii	洱
xji	铒
xjiovi	铒
xjiv	佴
xjivii	佴
xjo	咡
xjovii	咡
xju	儿
xjua	尔
xjuaa	儿
xjuaiu	尔
xjuao	迩
xjuaoa	迩
xjuav	饵
xjuavi	饵
xjuavu	鲕
xjv	耳
xjviiv	耳
xjvu	鸸
xjvuia	而
xjvuu	耏
xjvuua	鸸
xjvuuu	耏
xjvv	贰
xjvvv	珥 二
xjvvva	贰
xjvvvi	珥
xk	西
xka	戏
xkaa	细
xkaaia	细
xkaau	绤
xkaauo	𫘬 绤
xkai	隙
xkaiiu	隙
xkaio	隰
xkaioi	隰
xkao	习
xkaov	枲
xkaova	戏
xkaovv	习 枲
xkau	洗
xkaua	汐
xkauao	汐
xkaui	潟
xkauiv	潟
xkauo	溪
xkauoo	溪
xkauov	浠
xkauu	媳
xkauui	媳
xkauv	嬉
xkauvi	洗
xkauvo	嬉
xkav	犀
xkava	屃
xkavao	屃
xkavau	犀
xkavu	淅
xkavuu	屣 淅
xki	锡
xkia	螅
xkiaa	嶍
xkiaai	酅
xkiaao	嶍
xkiai	巇
xkiaio	嶲
xkiaiv	巇
xkiau	蟋
xkiaui	螅
xkiauo	睎 蟋
xkiav	蜥
xkiavu	蜥
xkii	茜
xkiii	葸
xkiiia	葸
xkiiu	蓰
xkiiuu	蓰
xkiiv	菥
xkiivi	茜
xkiivu	菥
xkio	铣
xkiooi	锡
xkiouv	铣
xkiov	𬭳
xkiovo	𬭳
xkiu	傒
xkiuo	俙
xkiuoo	傒
xkiuov	俙
xkiv	翕
xkivao	翕
xkivo	僖
xkivoo	僖
xkivu	歙
xkivua	歙
xko	席
xkoa	禧
xkoao	裼
xkoaoi	裼
xkoau	䜣
xkoauu	䜣
xkoav	禊
xkoavo	禧
xkoavv	禊
xkoi	晰
xkoio	曦
xkoiou	曦
xkoiu	蹊
xkoiui	阋
xkoiuo	晞 蹊
xkoiv	暿
xkoivo	暿
xkoivu	晰
xkoo	惜
xkoou	窸
xkooua	穸
xkoouo	窸
xkoouv	忾
xkoov	恓
xkoovi	惜 恓
xkou	吸
xkouao	吸
xkoui	熻
xkouiv	熻
xkouo	唏
xkouou	爔
xkouov	唏
xkouu	熄
xkouui	熄
xkouuo	烯
xkouuv	羲
xkouv	粞
xkouvi	粞
xkov	嘻
xkova	咥
xkovao	咥
xkovi	𠅤
xkovia	席 𠅤
xkovoo	嘻
xku	系
xkua	夕
xkuaa	鳛
xkuaao	鳛
xkuai	觿
xkuaia	觿
xkuaiu	系
xkuao	饻
xkuaoo	夕
xkuaov	饻
xkuau	饩
xkuauv	饩
xkuav	玺
xkuavo	𬶮
xkuavv	玺
xkui	息
xkuioa	息
xkuiu	舄
xkuiua	舄
xkuiuo	鼷
xkuo	希
xkuoa	奚
xkuoaa	奚
xkuoai	郗 郤
xkuoo	悉
xkuooa	悉
xkuouo	谿
xkuov	兮
xkuova	兮
xkuovu	希
xkuu	徙
xkuuiv	徙
xkuuo	肸
xkuuou	肸
xkuuv	舾
xkuuvi	舾
xkuv	稀
xkuvi	膝
xkuvia	膝
xkuvii	腊
xkuvuo	稀
xkuvv	牺
xkuvvi	牺
xkv	喜
xkva	樨
xkvavu	樨
xkvi	昔
xkviau	西
xkvii	觋
xkviia	觋
xkvio	熙
xkvioi	昔
xkvioo	熙
xkviov	醯
xkvo	熹
xkvoo	憙
xkvooa	憙
xkvooo	喜 熹
xkvu	析
xkvui	檄
xkvuia	檄
xkvuo	袭
xkvuov	袭
xkvuu	皙
xkvuui	皙
xkvuuo	豨
xkvuuv	析
xkvuv	硒
xkvuvi	硒
xkvv	栖
xkvvi	釐
xkvvia	栖 釐
xl	哦
xla	续
xlaa	绪
xlaai	湑
xlaaiv	湑
xlaauo	续 绪
xlaav	𦈡
xlaavo	𦈡
xlai	胥
xlaiuu	胥
xlaiv	溆
xlaivv	溆
xlao	浒
xlaoau	浒
xlaoi	矞
xlaoia	矞
xlau	婿
xlaua	絮
xlauaa	絮
xlauai	婿
xlaui	洫
xlauia	洫
xlav	㳚
xlavuo	㳚
xli	虚
xlia	勖
xliaau	勖
xliao	冔
xliaov	冔
xliav	盱
xliavv	盱
xlii	蓄
xliio	蓿
xliioo	蓿
xliiov	蓄
xliv	叙
xlivao	叙
xlivii	虚
xlo	许
xloa	喔
xloaa	诩
xloaai	谞
xloaao	诩
xloauv	许
xloav	𬣙
xloavu	喔
xloavv	𬣙
xloi	嘘
xloii	嚄
xloiii	嚄
xloio	煦
xloioo	煦
xloiu	昫
xloiua	昫
xloiv	旴
xloiva	嘘
xloivv	旴
xloo	恤
xlooui	恤
xlou	噢
xloua	糈
xlouai	糈
xlouia	噢
xlouu	欻
xlouua	欻
xlouvi	哦
xlov	序
xlovao	序
xlovi	畜
xlovia	畜
xlovv	吁
xlovvi	吁
xlu	须
xlua	旭
xluaoi	旭
xlui	魆
xluiva	魆
xluu	徐
xluua	媭
xluuau	媭
xluuiv	徐
xluuvu	须
xlv	需
xlva	栩
xlvaov	栩
xlvi	酗
xlvia	醑
xlviai	醑
xlviuo	酗
xlvo	墟
xlvoiv	墟
xlvoo	垿
xlvoov	垿
xlvov	圩
xlvovu	需
xlvovv	圩
xlvu	戌
xlvuvv	戌
xlvv	顼
xlvva	珝
xlvvao	珝
xlvvv	砉
xlvvvu	顼 砉
xm	先
xma	线
xmaa	纤
xmaau	缐
xmaaui	𫄧 缐
xmaauv	纤
xmaavv	线
xmai	限
xmaiav	限
xmaii	险
xmaiiv	险
xmaiu	陷
xmaiua	陷
xmau	嫌
xmaua	姆
xmauaa	姆
xmaui	涎
xmauii	孅
xmauiv	涎
xmauo	娴
xmauoi	娴
xmauou	嫌
xmauv	洗
xmauvi	洗
xmav	弦
xmavov	弦
xmi	县
xmia	岘
xmiaao	县
xmiai	蚬
xmiaia	𪾢 岘 蚬
xmiaiv	崄
xmiau	见
xmiaua	盷 见
xmii	仙
xmiia	贤
xmiiai	仙
xmiiao	贤
xmiii	苋
xmiiia	苋
xmiiiv	莶
xmiiu	藓
xmiiua	藓
xmio	锨
xmioo	锬
xmioou	锬
xmiou	铣
xmiouu	锨
xmiouv	铣
xmiov	伭
xmiova	伭
xmiu	掀
xmiua	掺
xmiuao	掺
xmiuav	挦
xmiuuu	掀
xmo	显
xmoa	诜
xmoaa	禒
xmoaaa	禒
xmoaao	呣
xmoauv	诜
xmoav	祆
xmoavu	𫍯
xmoavv	祆
xmoi	闲
xmoia	㬎
xmoiaa	㬎
xmoii	𬀪
xmoiia	𬀪
xmoiii	显
xmoio	暹
xmoioa	暹
xmoiu	跹
xmoiua	鹇
xmoiuv	跣 跹
xmoivv	闲
xmoo	宪
xmoou	忺
xmooua	𬸣 忺
xmoouv	宪
xmou	羡
xmoui	籼
xmouia	籼
xmouov	羡
xmov	痫
xmovoi	痫
xmovu	冼
xmovuv	冼
xmovv	呒
xmovvu	呒
xmu	鲜
xmua	馅
xmuai	猃
xmuaiv	猃
xmuaou	鲜
xmuau	狝
xmuaua	馅 狝
xmuo	献
xmuovu	献
xmuu	腺
xmuui	衔
xmuuia	腺
xmuuio	衔
xmuuo	舷
xmuuov	舷
xmuv	氙
xmuvia	氙
xmuvu	筅
xmuvua	先
xmuvuv	筅
xmv	现
xmvi	酰
xmviuv	酰
xmvo	霰
xmvovi	霰
xmvu	咸
xmvuo	燹
xmvuoo	咸
xmvuou	燹
xmvv	玹
xmvvia	现
xmvvov	玹
xn	恩
xni	摁
xniaoa	恩
xnii	蒽
xniiia	蒽
xniuia	摁
xno	嗯
xnoiav	嗯
xnov	唔
xnovia	唔
xp	昂
xpi	盎
xpiaia	盎
xpoiua	昂
xpu	肮
xpua	卬
xpuaai	卬
xpuovu	肮
xq	修
xqa	绣
xqaauv	绣
xqai	滫
xqaiiu	滫
xqau	溴
xqauia	溴
xqi	休
xqia	岫
xqiai	䗛
xqiaia	岫
xqiaii	䗛
xqii	脩
xqiiua	修 脩
xqio	锈
xqiouv	锈
xqiv	鸺
xqivua	鸺
xqivv	休
xqo	羞
xqoa	袖
xqoaia	袖
xqoi	咻
xqoivv	咻
xqoo	宿
xqooiv	宿
xqou	嗅
xqouai	羞
xqouia	嗅
xqov	庥
xqoviv	庥
xqu	秀
xqua	馐
xquaou	馐
xqui	臭
xquivu	臭
xquo	貅
xquoiv	貅
xquvau	秀
xqv	朽
xqvi	髹
xqviiv	髹
xqvv	琇
xqvvaa	朽
xqvvuv	琇
xqvvv	珛
xqvvvu	珛
xr	嗯
xro	唔
xroiav	嗯
xrovia	唔
xs	下
xsa	阿
xsaivo	阿
xsav	遐
xsava	叚
xsavav	叚
xsavoa	遐
xsi	侠
xsia	虾
xsiaa	翈
xsiaao	翈
xsiao	瞎
xsiaoo	瞎
xsiav	峡
xsiavi	虾
xsiavo	黠 峡
xsio	锕
xsioai	锕
xsivou	侠
xso	啊
xsoaiv	啊
xsoi	暇
xsoia	呷
xsoiav	暇 呷
xsoiv	唬
xsoiva	唬
xsoo	吖
xsooui	吖
xsov	吓
xsova	瘕
xsovav	瘕
xsovio	吓
xsovo	呵
xsovoi	呵
xsovu	嗄
xsovui	嗄
xsu	狭
xsua	狎
xsuaia	狎
xsuavo	狭
xsuv	罅
xsuviv	罅
xsuvu	腌
xsuvuo	腌
xsv	夏
xsva	辖
xsvaoo	辖
xsvi	匣
xsvia	柙
xsviav	匣 柙
xsvioo	下
xsvo	霞
xsvoav	霞
xsvou	槎
xsvouv	槎
xsvu	厦
xsvuua	夏
xsvuv	硖
xsvuvo	硖
xsvuvu	厦
xsvv	瑕
xsvvav	瑕
xt	选
xta	渲
xtaa	绚
xtaao	𫠊
xtaaov	𫠊
xtaaua	绚
xtao	漩
xtaooa	渲
xtaov	泫
xtaova	漩 泫
xtau	嬛
xtauia	嬛
xti	悬
xtia	眩
xtiaa	翾
xtiaao	翾
xtiaoa	悬
xtiaov	眩
xtii	萱
xtiia	儇
xtiiai	儇
xtiioo	萱
xtio	铉
xtioou	𫓶
xtioov	铉
xtiov	伭
xtiova	伭
xto	宣
xtoa	谖
xtoai	禤
xtoaia	𫍽 禤
xtoauo	谖
xtoi	暄
xtoio	昡
xtoioo	暅 暄
xtoiov	暶 昡
xtoiv	晅
xtoivo	晅
xtoo	喧
xtoooa	喧
xtoooo	愃
xtoovo	宣
xtou	炫
xtoua	券
xtouau	券
xtouo	煊
xtouoo	煊
xtouov	炫
xtouv	烜
xtouvo	烜
xtov	旋
xtova	玄
xtovaa	玄
xtovo	痃
xtovoi	咺
xtovov	痃
xtovu	癣
xtovua	癣
xtovuv	旋
xtu	衒
xtuuov	衒
xtuvoa	选
xtv	璇
xtva	轩
xtvavv	轩
xtvo	楦
xtvooa	楦
xtvu	碹
xtvuoo	碹
xtvv	瑄
xtvvo	玹
xtvvoo	瑄
xtvvou	琄
xtvvov	璇 玹
xw	寻
xwa	巡
xwaa	驯
xwaao	浚
xwaaoa	巡
xwaaou	浚
xwaau	𬘓
xwaaui	驯 𬘓
xwaauv	𫄸
xwaav	汛
xwaavi	汛
xwaavv	浔
xwai	逊
xwaioa	逊
xwao	欸
xwaoua	欸
xwau	洵
xwauao	洵
xwav	迅
xwava	𬩽
xwavai	𬩽
xwavoa	迅
xwavv	巽
xwavvi	寻 巽
xwi	薰
xwia	峋
xwiaua	峋
xwii	荀
xwiia	荨
xwiiav	荨
xwiiua	荀
xwiiuv	薰
xwiiv	蕈
xwiiva	荤
xwiivi	蕈
xwo	训
xwoa	讯
xwoaa	勋
xwoaau	勋
xwoaav	讯
xwoau	询
xwoaua	询
xwoaui	训
xwoav	噀
xwoava	噀
xwoi	曛
xwoiuv	曛
xwoo	恂
xwooo	窨
xwooov	窨
xwooua	恂
xwou	𬊈
xwouav	𬊈
xwu	循
xwua	旬
xwuaa	鲟
xwuaai	郇
xwuaav	鲟
xwuaoi	旬
xwuau	獯
xwuauv	獯
xwuu	徇
xwuuua	徇
xwuuuu	循
xwuv	熏
xwuvoo	熏
xwv	殉
xwvi	醺
xwviuv	醺
xwvo	埙
xwvooa	埙
xwvu	栒
xwvuao	栒
xwvuua	殉
xwvv	珣
xwvva	𬍤
xwvvav	𬍤
xwvvua	珣
xx	想
xxa	乡
xxaa	飨
xxaaio	飨
xxaao	骧
xxaaov	𬙋 骧
xxaauu	乡
xxaav	缃
xxaavi	缃
xxai	降
xxaiua	降
xxav	湘
xxavia	湘
xxi	像
xxii	芗
xxiiaa	芗
xxiiv	葙
xxiivi	葙
xxio	镶
xxioov	镶
xxiuai	像
xxo	响
xxoa	详
xxoao	祥
xxoaou	详 祥
xxou	翔
xxouao	翔
xxouia	响
xxouu	鲞
xxouua	鲞
xxov	享
xxovai	享
xxovo	襄
xxovoo	襄
xxovou	庠
xxu	向
xxua	象
xxuaia	象
xxuau	饷
xxuaui	饷
xxuioo	向
xxuv	香
xxuvoi	香
xxuvv	箱
xxuvvi	箱
xxv	相
xxvi	项
xxvia	巷
xxviav	相 巷
xxvioa	想
xxvivu	项
xxvu	厢
xxvua	橡
xxvuai	橡
xxvuvi	厢
xxvv	珦
xxvvo	瓖
xxvvov	瓖
xxvvui	珦
xy	熊
xya	汹
xyaooo	熊
xyauoa	汹
xyi	芎
xyiiav	芎
xyo	兄
xyoa	讻
xyoai	诇
xyoaia	诇
xyoauo	讻
xyouaa	兄
xyu	胸
xyua	匈
xyuau	夐
xyuaua	夐
xyuauo	匈
xyuo	凶
xyuoai	凶
xyuuau	胸
xyv	雄
xyvuio	雄
xz	奥
xza	澳
xzai	隩
xzaiui	隩
xzau	媪
xzauia	澳
xzauoi	媪
xzi	傲
xzia	凹
xziaia	凹
xzii	薁
xziiui	薁
xziu	拗
xziuaa	拗
xzivvi	傲
xzo	噢
xzoa	袄
xzoauv	袄
xzoo	懊
xzooui	懊
xzoov	嚣
xzoovu	嚣
xzouia	噢
xzov	嗷
xzovi	鏖
xzovio	鏖
xzovv	廒
xzovvi	嗷
xzovvv	廒
xzu	翱
xzuiao	翱
xzuivu	奥
xzuv	岙
xzuvia	岙
xzv	熬
xzvo	坳
xzvoaa	坳
xzvu	奡
xzvuvu	奡
xzvv	鳌
xzvva	骜
xzvvaa	骜
xzvvi	螯
xzvvia	嶅 螯
xzvvio	鏊
xzvvo	遨
xzvvoa	遨
xzvvoo	熬
xzvvu	敖
xzvvua	鳌
xzvvuv	敖
xzvvv	獒
xzvvvi	聱
xzvvvu	獒
xzvvvv	璈
y	一
yb	因
yba	引
ybaa	骃
ybaai	𬘡
ybaaia	骃 𬘡
ybai	阴
ybaia	洇
ybaiav	洇
ybaiu	隐
ybaiua	隐
ybaiuu	阴
ybau	淫
ybaui	姻
ybauia	姻
ybauoo	淫
ybauu	溵
ybauua	溵
ybav	尹
ybavi	湮
ybavia	湮
ybavii	引
ybavvu	尹
ybi	银
ybia	蚓
ybiaav	蚓
ybiai	崟
ybiaio	崟
ybiav	蟫
ybiavi	蟫
ybiavu	因
ybii	荫
ybiiai	荫
ybiii	茵
ybiiia	茵
ybiiu	茚
ybiiua	茚
ybio	铟
ybioav	银
ybioia	铟
ybiv	龈
ybivav	龈
ybivu	龂
ybivuu	龂
ybo	音
yboa	吲
yboav	禋
yboava	吲
yboavi	𬤇 禋
yboi	吟
yboio	訚
yboioa	吟
yboiov	訚
yboiv	𬮱
yboivi	𬮱
yboo	寅
ybooo	窨
ybooov	愔 窨
yboov	喑
yboovi	嚚 寅
yboovo	喑
ybou	烟
ybouia	烟
ybov	瘾
ybovai	瘾
ybovoi	音
ybu	印
ybua	饮
ybuaa	胤
ybuaai	印
ybuaao	胤
ybuao	夤
ybuaoo	夤
ybuaov	狺
ybuau	䲟
ybuaua	饮 䲟
ybuu	殷
ybuuua	殷
ybuv	氤
ybuvia	氤
ybv	垠
ybvi	鄞
ybviai	鄞
ybviu	歅
ybviua	歅
ybvo	堙
ybvoa	霪
ybvoau	霪
ybvoav	垠
ybvoo	慭
ybvooa	慭
ybvou	圻
ybvouu	圻
ybvovi	堙
ybvu	硍
ybvuav	硍
ybvv	珢
ybvvav	珢
yd	有
yda	又
ydaa	幼
ydaaau	幼
ydai	油
ydaiav	油
ydaii	浟
ydaiiu	浟
ydao	游
ydaoo	又
ydaova	游
ydi	由
ydia	邮
ydiaa	幽
ydiaaa	蚴 黝
ydiaai	邮
ydiaao	幽
ydiai	蚰
ydiaia	蚰
ydiao	蝣
ydiaou	蝤
ydiaov	蝣
ydiav	囿
ydiavi	由
ydiavu	囿
ydii	悠
ydiii	莜
ydiiii	莜
ydiioa	悠
ydiiu	攸
ydiiua	莸
ydiiuv	莠 攸
ydio	铀
ydioia	铀
ydiov	铕
ydiovu	铕
ydiv	优
ydivi	卣
ydivia	卣
ydivu	佑
ydivua	优
ydivuo	佑
ydivuu	侑
ydo	忧
ydoa	诱
ydoaa	呦
ydoaao	呦
ydoauv	诱
ydoav	祐
ydoavu	祐
ydoo	宥
ydoovu	忧 宥
ydou	猷
ydouu	羑
ydouua	羑
ydouvu	猷
ydov	疣
ydovu	麀
ydovua	麀
ydovvu	疣
ydu	犹
ydua	鱿
yduai	鲉
yduaia	鲉
yduavu	犹 鱿
ydui	牖
yduii	鼬
yduiia	鼬
yduioa	牖
yduo	釉
yduoia	釉
yduou	繇
yduoua	繇
ydv	右
ydva	𬨎
ydvaou	𬨎
ydvi	酉
ydvia	柚
ydviau	酉
ydviav	柚
ydvu	友
ydvua	尤
ydvuaa	尢
ydvuao	友 尤
ydvuoo	右
ydvuuu	有
ydvv	槱
ydvvia	槱
ydvvv	耰
ydvvvu	耰
ye	也
yea	液
yeaiaa	也
yeaovi	液
yei	业
yeia	野
yeiaao	野
yeiav	曳
yeiavv	曳
yeii	邺
yeiiai	邺
yeiiou	业
yeio	铘
yeiova	铘
yeiu	掖
yeiui	拽
yeiuia	拽
yeiuov	掖
yeiuv	揶
yeiuvi	揶
yeiv	倻
yeivii	倻
yeo	夜
yeoa	谒
yeoaoi	谒
yeoi	咽
yeoiav	咽
yeoii	晔
yeoiiu	晔
yeoo	喝
yeooiu	喝
yeou	叶
yeoui	烨
yeouiu	烨
yeouoo	叶
yeov	冶
yeovao	冶
yeoviu	夜
yeovo	噎
yeovoo	噎
yeu	爷
yeua	馌
yeuavo	馌
yeui	射
yeuivi	射
yeuo	腋
yeuoai	爷
yeuovi	腋
yev	页
yeva	邪
yevaai	邪
yevi	耶
yeviai	耶
yevu	靥
yevuao	页
yevuvu	靥
yevv	椰
yevvii	椰
yf	眼
yfa	沿
yfaa	验
yfaaiv	验
yfaao	沇
yfaaoo	𬙂
yfaaou	沇
yfaau	𫄧
yfaaui	𫄧
yfai	渰
yfaii	阽
yfaiiv	阽
yfaivo	渰
yfao	演
yfaooa	演
yfau	妍
yfauao	沿
yfauv	嫣
yfauvi	嬿 嫣
yfauvv	妍
yfav	淹
yfavi	湮
yfavia	湮
yfaviv	漹
yfavuo	淹
yfavv	滟
yfavvv	滟
yfi	岩
yfia	蜒
yfiaa	觃
yfiaai	觃
yfiaav	眼
yfiau	𪩘
yfiaui	蜒
yfiauo	𪩘
yfiav	罨
yfiavo	蝘
yfiavu	崦 岩 罨
yfiiv	芫
yfiivv	芫
yfio	铅
yfioua	铅
yfiu	掩
yfiuvu	掩
yfiv	俨
yfivi	虤
yfivii	俨
yfiviv	虤
yfivo	偃
yfivoi	偃
yfivv	弇
yfivva	甗
yfivvu	弇
yfo	言
yfoa	谚
yfoao	扊
yfoaou	扊
yfoaov	谚
yfoau	谳
yfoauo	谳
yfoi	咽
yfoiav	咽
yfoio	晏
yfoioo	晏
yfoiov	阏
yfoiu	阎
yfoiua	阎
yfoiv	阉
yfoivu	阉
yfoivv	闫
yfoo	宴
yfoooi	宴
yfoov	唁
yfoova	戭
yfoovu	恹
yfoovv	唁
yfou	烟
yfoui	剡
yfouia	烟
yfouii	剡
yfouo	炎
yfouou	焱 炎
yfouu	焰
yfouua	焰
yfouui	烻
yfov	颜
yfovu	彦
yfovuo	兖
yfovuu	彦
yfovvu	颜
yfovvv	言
yfu	延
yfui	胭
yfuiao	延
yfuiav	胭
yfuio	鼹
yfuioi	鼹
yfuu	衍
yfuuav	衍
yfuuu	殷
yfuuua	殷
yfuv	腌
yfuvu	筵
yfuvui	筵
yfuvuo	腌
yfv	研
yfvi	严
yfvia	鄢
yfviai	鄢
yfviio	严
yfvio	燕
yfvioo	燕
yfviu	歅
yfviua	歅
yfviv	焉
yfviva	焉
yfvivi	酽
yfvo	盐
yfvoa	郾
yfvoai	郾
yfvoia	盐
yfvou	埏
yfvoua	𬸘
yfvoui	棪 埏
yfvov	堰
yfvovi	墕
yfvovo	堰
yfvu	厌
yfvua	檐
yfvuao	赝
yfvuav	檐
yfvui	奄
yfvuia	砚 厣 奄 黡
yfvuii	雁
yfvuio	餍
yfvuu	魇
yfvuui	魇
yfvuv	䶮
yfvuvu	厌
yfvuvv	研 䶮
yfvv	艳
yfvvo	琰
yfvvou	琰
yfvvua	艳
yg	应
yga	盈
ygaa	缨
ygaaao	缨
ygai	滢
ygaii	潆
ygaiio	溁 滢 潆
ygao	婴
ygaoau	婴
ygaou	鹦
ygaoua	鹦
ygaouv	罂
ygaov	瀛
ygaova	瀛
ygau	媖
ygauia	盈
ygauii	媖
ygi	英
ygia	蝇
ygiaoi	蝇
ygii	营
ygiia	萦
ygiiaa	荥 萦
ygiii	萤
ygiiia	英 萤
ygiiio	蓥
ygiio	荧
ygiioo	营
ygiiou	荧
ygiiu	莺
ygiiua	莺
ygiiuv	䓨
ygiiv	莹
ygiivo	茔
ygiivv	莹
ygio	锳
ygioii	锳
ygiu	撄
ygiuao	撄
ygo	影
ygoa	嘤
ygoaoa	嘤
ygoi	映
ygoiia	映
ygoiuu	影
ygov	赢
ygova	嬴
ygovai	郢
ygovao	瘿 赢
ygovau	嬴
ygovoo	应
ygovu	鹰
ygovua	鹰
ygovuu	膺
ygu	迎
ygua	颖
yguaoa	迎
yguav	颍
yguavu	颖 颍
yguo	媵
yguoau	媵
ygv	硬
ygva	樱
ygvaoa	樱
ygvau	楹
ygvaua	楹
ygvuvi	硬
ygvv	瑛
ygvva	璎
ygvvao	璎
ygvvii	瑛
yh	月
yha	约
yhaaua	约
yhai	瀹
yhaivo	瀹
yhav	彟
yhavii	彟
yhi	钥
yhio	钺
yhiouu	钥
yhiova	钺
yhiv	龠
yhivoo	龠
yho	阅
yhoa	说
yhoaou	说
yhoi	跃
yhoia	哕
yhoiai	哕
yhoii	曰
yhoiou	阅
yhoiuv	跃
yhoo	悦
yhooou	悦
yhou	爚
yhouiv	爚
yhu	乐
yhua	𬸚
yhuaiu	乐
yhuaua	𬸚
yhui	岳
yhuii	刖
yhuiia	岳
yhuiii	刖
yhuiv	粤
yhuiva	粤
yhuu	月
yhuv	籥
yhuviv	籥
yhv	越
yhvav	𫐄
yhvavu	𫐄
yhvova	越
yhvu	栎
yhvuai	栎
yhvv	玥
yhvvo	樾
yhvvoi	樾
yhvvuu	玥
yk	以
yka	已
ykaa	乙
ykaaa	驿
ykaaao	绎 驿
ykaao	缢
ykaaou	彝 缢
ykaaov	𫄷
ykai	洢
ykaia	潩
ykaiav	洢 潩
ykao	矣
ykaoa	贻
ykaoai	浥
ykaoao	贻
ykaoi	翼
ykaoia	翼
ykaoii	以
ykaoo	翌
ykaoov	翌
ykaou	溢
ykaouv	矣 溢
ykaov	羿
ykaovu	羿
ykau	姨
ykaua	漪
ykauaa	㴔
ykauau	漪
ykauu	沂
ykauuv	沂
ykauv	嫕
ykauva	姨
ykauvu	嫕
ykav	异
ykavaa	已
ykavu	尾
ykavuv	尾
ykavvu	异
yki	依
ykia	亿
ykiaa	峄 亿
ykiaao	眙 峄
ykiao	遗
ykiaoa	遗
ykiaoi	蜴
ykiaoo	佁 蛇
ykiaou	蚁 螠
ykiau	屹
ykiaua	嶷 黟
ykiauv	蛾 屹
ykiav	伊
ykiavu	𫖮
ykiavv	伊
ykii	艺
ykiia	苡
ykiiaa	艺
ykiiao	苡
ykiio	薏
ykiiov	薏
ykiiu	艾
ykiiuo	艾
ykiiv	荑
ykiiva	荑
ykiivo	𬟁
ykio	仪
ykioa	钇
ykioaa	钇
ykioav	食
ykioo	铱
ykioou	镒
ykioov	镱 铱
ykiouo	仪
ykiov	㑊
ykiova	𬬩
ykiovu	依 㑊
ykiu	抑
ykiuo	揖
ykiuoa	挹
ykiuou	佾
ykiuov	揖
ykiuua	抑
ykiuv	佚
ykiuva	仡
ykiuvv	佚
ykiv	倚
ykivuo	倚
ykivv	𬺈
ykivvu	𬺈
yko	亦
ykoa	议
ykoaa	译
ykoaao	诒 译
ykoai	邑
ykoaiv	邑
ykoao	谊
ykoaoo	谊
ykoaou	议
ykoaov	扆
ykoau	诣
ykoaua	扅 诣
ykoav	祎
ykoavv	祎
ykoi	易
ykoia	咿
ykoiav	咿
ykoii	呓
ykoiia	呓
ykoiu	昳
ykoiua	易
ykoiuv	昳
ykoiv	踦
ykoivu	踦
ykoo	宜
ykooa	忆
ykooaa	忆
ykooao	怡 怿
ykooia	宜
ykooo	悒
ykoooa	悒
ykoou	嗌
ykoouv	嗌
ykoov	噫
ykoovi	宧
ykoovo	噫
ykou	义
ykoua	熠
ykouao	熠
ykoui	益
ykouia	益
ykouo	燚
ykouoo	义
ykouou	燚
ykouu	鹢
ykouua	鹢
ykov	衣
ykova	咦
ykovao	翊
ykovav	咦
ykovi	裔
ykovia	廙 裔
ykovo	意
ykovoa	裛 意
ykovov	癔
ykovu	毅
ykovua	疫 衣 毅
ykovui	亦
ykovuv	旖
ykovv	弈
ykovva	痍
ykovvo	瘗
ykovvu	奕 弈
yku	疑
ykua	逸
ykuaa	肄
ykuaao	饴 疑
ykuaav	肄
ykuaoa	逸
ykuav	猗
ykuavu	猗
ykui	射
ykuii	劓
ykuiii	劓
ykuivi	射
ykuo	臆
ykuoi	刈
ykuoii	刈
ykuoo	乂
ykuovo	臆
ykuu	役
ykuuo	舣
ykuuou	舣
ykuuua	役
ykuv	移
ykuva	胰
ykuvav	胰
ykuvo	迤
ykuvoa	迤
ykuvu	簃
ykuvua	移
ykuvuv	簃
ykv	医
ykva	夷
ykvai	匜
ykvaia	匜
ykvao	弋
ykvaoo	弋
ykvau	轶
ykvauv	轶
ykvava	夷
ykvi	颐
ykvia	酏
ykviai	酏
ykviau	勚
ykvivu	颐
ykvo	壹
ykvoa	圯
ykvoav	圯
ykvoo	懿
ykvooi	埸
ykvoov	懿
ykvou	鹝
ykvoua	鹝
ykvov	椸
ykvova	椸
ykvovo	壹
ykvu	翳
ykvua	繄
ykvuaa	繄
ykvuao	翳
ykvuo	枍
ykvuov	枍
ykvuu	欹
ykvuua	欹
ykvuv	殪
ykvuvo	殪
ykvuvv	医
ykvv	椅 一
ykvva	杙
ykvvao	杙
ykvvuo	椅
yl	与
yla	预
ylaa	驭
ylaaao	驭
ylaao	滪
ylaaoa	潏 滪
ylaav	纡
ylaavv	纡
ylai	隅
ylaii	隃
ylaiia	隅
ylaiiv	隃
ylaiu	隩
ylaiui	隩
ylaiv	渝
ylaivu	渝
ylao	予
ylaoa	羽
ylaoai	予
ylaoao	羽
ylaoi	汩
ylaoia	矞
ylaoii	汩
ylaoo	遹
ylaooa	遹
ylaou	豫
ylaoua	鹬 豫
ylaov	淤
ylaova	淯 淤
ylaovu	预
ylau	浴
ylaua	渔
ylauai	渔
ylauao	妤
ylauo	娱
ylauoi	浴
ylauov	娱
ylauv	妪
ylauvu	妪
ylav	鬻
ylavo	熨
ylavou	粥 熨
ylavu	㳚
ylavuo	㳚
ylavv	聿
ylavvi	尉
ylavvo	鬻
ylavvv	聿
yli	余
ylia	遇
yliai	嵛
yliaia	嵎 髃
yliaiv	蝓 嵛
yliao	愚
yliaoa	遇 愚
yliau	峪
yliauo	峪
yliav	屿
yliava	屿
yliavi	圄
yliavo	圉 蜮
yliavv	禺
ylii	芋
yliia	蓣
yliiao	蓣
yliiav	蔚
yliio	菀
yliioo	菀
yliiu	萸
yliiui	薁 萸
yliivv	芋
ylio	钰
yliov	俣
yliovi	铻
yliovv	钰 俣
yliu	揄
yliuiv	揄
yliv	愈
ylivi	觎
ylivia	畬 觎
ylivo	逾
ylivoa	悆 愈 逾
ylivov	虞
ylivu	俞
ylivui	俞
ylivuo	伛
ylivv	龉
ylivvi	龉
ylivvv	余
ylo	语
yloa	裕
yloaa	哟
yloaav	哟
yloai	谕
yloaiv	褕 谕
yloau	谀
yloaui	谀
yloauo	裕
yloavi	语
yloi	喻
yloia	喁
yloiav	喁
yloio	昱
yloiov	阏 昱
yloiv	阈
yloivo	阈
yloivu	喻
yloo	寓
ylooi	愉
ylooia	寓
ylooiv	窬 愉
ylooo	誉
ylooov	誉
yloou	窳
yloouu	窳
yloov	宇
yloova	唷
yloovv	宇
ylou	煜
yloua	燏
ylouao	燏
ylouoi	煜
ylouu	燠
ylouui	燠
ylov	育
ylovi	於
ylovio	於
ylovo	瘀
ylovov	瘀
ylovu	庾
ylovui	瘐 庾
ylovuu	育
ylovv	吁
ylovvi	吁
ylu	鱼
ylua	狱
yluaia	鱼
yluaiv	狳 㺄
yluaoa	狱
yluau	饫
yluauv	饫
ylui	舆
yluia	禹
yluiai	鄅
yluiav	禹
yluiuo	舆
yluiv	臾
yluiva	臾
yluivu	舁
yluo	欲
yluoo	谷
yluooo	谷
yluou	鹆
yluoua	欲 鹆
yluu	御
yluui	腴
yluuiv	艅 腴
yluuuv	御
yluv	竽
yluvo	毓
yluvov	毓
yluvvv	竽
ylv	于
ylva	欤
ylvaua	欤
ylvavv	与
ylvi	雨
ylviai	雨
ylviu	敔
ylviuv	敔
ylviv	榆
ylvivu	榆
ylvo	域
ylvoo	堉
ylvoov	堉
ylvou	圫
ylvouv	圫
ylvov	雩
ylvova	彧
ylvovo	域
ylvovv	雩
ylvu	郁
ylvuai	郁
ylvv	玉
ylvva	邘
ylvvai	邘
ylvvi	瑜
ylvvia	盂
ylvvii	于
ylvviv	玉 瑜
ylvvo	迂
ylvvoa	迂
ylvvov	棫
ylvvu	瑀
ylvvui	瑀
ylvvv	玙
ylvvva	玙
yp	样
ypa	洋
ypai	阳
ypaia	泱
ypaiav	泱
ypaioi	阳
ypao	漾
ypaouv	洋 漾
ypi	扬
ypia	央
ypiao	蛘
ypiaou	蛘
ypiau	鸯
ypiaua	鸯
ypiavu	央
ypio	佯
ypioa	钖
ypioau	钖
ypiouv	佯
ypiu	仰
ypiuaa	仰
ypiuau	扬
ypo	养
ypoi	旸
ypoia	咉
ypoiau	旸
ypoiav	咉
ypoo	怏
ypooia	怏
ypou	羊
ypoua	炀
ypouau	炀
ypouo	恙
ypouoa	羕 恙
ypouou	烊
ypouui	养
ypouvv	羊
ypov	痒
ypova	疡
ypovau	疡
ypovou	痒
ypu	氧
ypua	卬
ypuaa	飏
ypuaai	卬
ypuaau	飏
ypuu	徉
ypuuou	徉
ypuv	秧
ypuvia	秧
ypuvou	氧
ypv	杨
ypvauu	杨
ypvi	鞅
ypviia	鞅
ypvo	垟
ypvoou	垟
ypvouv	样
ypvu	殃
ypvuia	殃
ypvv	玚
ypvvau	玚
ys	压
ysa	涯
ysau	娅
ysauvi	娅
ysavuv	涯
ysi	押
ysia	鸭
ysiaua	鸭
ysiav	崖
ysiava	岈 蚜
ysiavu	睚 崖
ysii	芽
ysiiva	芽
ysiu	揠
ysiuia	押
ysiuvo	揠
ysiv	伢
ysivai	伢
yso	呀
ysoa	讶
ysoava	讶
ysoo	吖
ysooui	吖
ysou	丫
ysouii	丫
ysov	哑
ysovai	呀
ysovii	哑
ysu	衙
ysua	猰
ysuavv	猰
ysuuvi	衙
ysuv	氩
ysuvvi	氩
ysv	牙
ysva	雅
ysvaa	轧
ysvaaa	轧
ysvaai	邪
ysvaio	雅
ysvaiu	牙
ysvao	迓
ysvaoa	迓
ysvau	鸦
ysvaua	鸦
ysvi	亚
ysviio	亚
ysvo	垭
ysvov	堐
ysvovi	垭
ysvovu	堐
ysvu	砑
ysvuva	砑
ysvuvo	压
ysvv	桠
ysvvii	桠
ysvvv	琊
ysvvva	玡 琊
yt	元
yta	院
ytaa	缘
ytaaaa	缘
ytaav	𫘪
ytaavu	𫘪
ytaioo	院
ytaoo	涴
ytaooa	涴
ytau	渊
ytauo	湲
ytauoo	湲
ytauou	渊
ytauu	媛
ytauuo	媛
ytauv	嫄
ytauvu	嫄
ytauvv	妧
ytav	源
ytavuu	源
ytavv	沅
ytavvu	沅
yti	园
ytia	圆
ytiai	圜
ytiaia	圜
ytiao	蜎
ytiaoa	圆
ytiaou	蜎
ytiav	螈
ytiavu	螈
ytiavv	园
ytii	苑
ytiiua	苑
ytiiv	芫
ytiivo	薳
ytiivv	芫
ytiu	援
ytiua	掾
ytiuaa	掾
ytiuuo	援
yto	员
ytoa	冤
ytoaoo	员
ytoaua	冤
ytoo	宛
ytooua	宛
ytou	羱
ytouvu	羱
ytu	怨
ytua	猿
ytuai	眢
ytuaia	眢
ytuaoa	怨
ytuau	鸳
ytuaua	鸳
ytuavo	猿
ytuo	爰
ytuovv	爰
ytuv	箢
ytuvoo	箢
ytv	原
ytva	辕
ytvaa	橼
ytvaav	橼
ytvau	鸢
ytvaua	鸢
ytvavo	辕
ytvo	袁
ytvoo	垸
ytvooo	垸
ytvoou	袁
ytvov	垣
ytvovo	垣
ytvovu	塬
ytvu	愿
ytvuoa	愿
ytvuui	原
ytvv	远
ytvvo	鼋
ytvvoa	远
ytvvoi	鼋
ytvvu	瑗
ytvvua	元
ytvvuo	瑗
yw	云
ywa	允
ywaa	纭
ywaao	缊
ywaaoi	缊
ywaavv	纭
ywai	陨
ywaioa	陨
ywao	涢
ywaoao	涢
ywaoua	允
ywau	孕
ywauai	孕
ywauv	妘
ywauvv	妘
ywav	熨
ywavou	熨
ywavv	沄
ywavva	沄
ywavvu	𫖳
ywi	蕴
ywii	芸
ywiia	蕰
ywiiaa	蕴
ywiiao	蕰
ywiio	菀
ywiioo	菀
ywiivv	芸
ywo	晕
ywoa	郧
ywoaa	郓
ywoaai	郧 郓
ywoao	员
ywoaoo	员
ywoi	昀
ywoioa	晕
ywoiua	昀
ywoo	愠
ywooo	恽
ywoooa	恽
ywoooi	愠
ywou	煴
ywouoi	煴
ywov	韵
ywova	赟
ywovao	赟
ywovua	韵
ywu	匀
ywua	狁
ywuaao	狁
ywuaov	匀
ywuv	氲
ywuvo	筼
ywuvoa	筼
ywuvoi	馧 氲
ywuvv	筠
ywuvvo	筠
ywv	运
ywvi	酝
ywvivv	酝
ywvo	鋆
ywvoio	鋆
ywvu	殒
ywvuoa	殒
ywvv	耘
ywvvao	云
ywvvo	韫
ywvvoa	运
ywvvoi	韫
ywvvvv	耘
yy	用
yya	勇
yyaa	涌
yyaao	邕
yyaaoa	邕
yyaaoi	涌
yyao	泳
yyaoaa	泳
yyaoau	勇
yyaoi	甬
yyaoia	甬
yyaoo	恿
yyaooa	恿
yyaov	澭
yyaova	澭
yyi	拥
yyia	蛹
yyiaao	蛹
yyiao	俑
yyiaoi	俑
yyiav	颙
yyiavu	颙
yyio	镛
yyioov	镛
yyiu	佣
yyiuav	佣
yyiuua	拥
yyo	永
yyoaau	永
yyoi	踊
yyoia	喁
yyoiao	踊
yyoiav	喁
yyoo	咏
yyooaa	咏
yyooo	慵
yyooov	慵
yyou	㶲
yyouua	㶲
yyov	庸
yyova	雍
yyovaa	雍
yyovai	鄘
yyovav	庸
yyovi	饔
yyovio	饔
yyovu	痈
yyovua	痈
yyovv	壅
yyovvo	壅
yyu	臃
yyua	鳙
yyuaa	鲬
yyuaao	鲬
yyuaov	鳙
yyuavv	用
yyuova	臃
yyv	墉
yyvo	栐
yyvoa	埇
yyvoaa	栐
yyvoao	埇
yyvoov	墉
yz	要
yza	妖
yzaa	幺
yzaaoo	幺
yzaau	约
yzaaua	约
yzai	陶
yzaiua	陶
yzao	滧
yzaovu	滧
yzau	姚
yzauu	媱
yzauuo	姚 媱
yzauuv	妖
yzi	药
yzia	崾
yziav	峣
yziava	峣
yziavi	崾
yziiaa	药
yzio	耀
yzioao	耀
yziou	钥
yziouo	铫
yziouu	钥
yziu	摇
yziuuo	摇
yziv	侥
yzivau	侥
yzo	咬
yzoa	谣
yzoaa	吆
yzoaao	吆
yzoauo	谣
yzoi	曜
yzoiao	曜
yzoo	窑
yzooa	窈
yzooaa	窈
yzooi	窅
yzooia	窅
yzoouv	窑
yzoovu	咬
yzov	疟
yzovva	疟
yzu	腰
yzua	鳐
yzuai	乐
yzuaiu	乐
yzuao	么
yzuaoo	么
yzuau	猺
yzuauo	鳐 猺
yzui	邀
yzuioa	邀
yzuo	遥
yzuooa	遥
yzuou	舀
yzuoua	鹞 繇
yzuoui	舀
yzuouo	爻
yzuov	肴
yzuovu	肴
yzuu	徭
yzuuu	徼
yzuuui	徼
yzuuuo	徭
yzuv	夭
yzuvia	腰
yzuvuo	夭
yzv	瑶
yzva	尧
yzvaa	轺
yzvaau	轺
yzvavu	尧
yzvi	靿
yzviaa	靿
yzviau	要
yzvo	杳
yzvoii	杳
yzvov	垚
yzvovi	㙘
yzvovo	垚
yzvv	珧
yzvvuo	瑶 珧
z	在
zb	最
zbi	罪
zbiaiv	罪
zbii	蕞
zbiioi	蕞
zbiv	觜
zbivua	觜
zbo	嘴
zboi	咀
zboiav	咀
zboivi	最 嘴
zbv	醉
zbvi	槜
zbviov	醉 槜
zd	走
zda	驺
zdaaua	驺
zdai	陬
zdaivi	陬
zdi	揍
zdiuvv	揍
zdo	诹
zdoavi	诹
zdu	邹
zdua	鲰
zduaai	邹
zduavi	鲰
zdv	奏
zdvi	鄹
zdviai	鄹
zdvoiv	走
zdvvvv	奏
ze	则
zea	泽
zeaaov	泽
zeaoii	则
zei	择
zeia	帻
zeiao	侧
zeiaoi	侧
zeiavv	帻
zeiuao	择
zeo	咋
zeoi	昃
zeoivu	昃
zeouvi	咋
zeov	啧
zeovvi	啧
zeu	舴
zeua	鲗
zeuaao	鲗
zeuuuv	舴
zeuv	迮
zeuvoa	迮
zeuvu	笮
zeuvuv	笮
zeuvv	箦
zeuvvv	箦
zev	责
zevi	赜
zevivv	赜
zevu	仄
zevuii	仄
zevvao	责
zfi	攒
zfiu	拶
zfiuaa	拶
zfiuuv	攒
zfo	咱
zfoo	寁
zfoova	寁
zfou	糌
zfouia	咱
zfouua	糌
zfu	赞
zfua	昝
zfuaoi	昝
zfuv	簪
zfuvai	酂
zfuvao	赞
zfuvva	簪
zfv	暂
zfva	錾
zfvaio	錾
zfvaoi	暂
zfvo	趱
zfvouv	趱
zfvv	瓒
zfvvuv	瓒
zh	再
zha	甾
zhaaia	甾
zhi	仔
zhia	崽
zhiaia	崽
zhiaiv	仔
zho	灾
zhoo	宰
zhooou	灾
zhooov	宰
zhu	载
zhuo	栽
zhuoo	哉
zhuooo	哉
zhuova	载
zhuovv	栽
zhviai	再
zhvuvo	在
zj	组
zja	阻
zjaaia	组
zjaiia	阻
zji	俎
zjia	崒
zjiaov	崒
zjii	菹
zjiiai	菹
zjiiia	俎
zjio	镞
zjioov	镞
zjo	足
zjoa	祖
zjoai	诅
zjoaia	祖 诅
zjoi	蹴
zjoiov	蹴
zjoivu	足
zjov	族
zjovi	卒
zjovii	卒
zjovuv	族
zju	租
zjuvia	租
zjv	珇
zjvvia	珇
zk	字
zka	子
zkaa	淄
zkaaa	缁
zkaaaa	淄 缁
zkaai	甾
zkaaia	甾
zkai	孜
zkaia	孖
zkaiai	孖
zkaiuv	孜
zkaivv	子
zkao	滋
zkaoo	滓
zkaooa	滓
zkaouv	滋
zkau	姊
zkauua	姊
zkav	渍
zkavvi	渍
zki	紫
zkia	仔
zkiaa	虸
zkiaai	虸
zkiai	眦
zkiaiv	仔 眦
zkiao	嵫
zkiaou	嵫
zkii	茈
zkiiiv	茈
zkio	锱
zkioaa	锱
zkioo	镃
zkioou	镃
zkiv	龇
zkiva	赀
zkivaa	紫
zkivao	赀
zkiviv	龇
zkivo	訾
zkivov	訾
zkivu	觜
zkivua	觜
zko	资
zkoi	呲
zkoivi	呲
zkoo	嗞
zkooai	字
zkoouv	嗞
zkou	兹
zkoua	孳
zkouaa	兹
zkouai	籽 孳
zkouo	吱
zkouoa	吱
zkov	姿
zkovao	资
zkovau	姿
zkovo	咨
zkovoa	恣
zkovoo	咨
zkovou	粢
zku	自
zkua	鲻
zkuaaa	鲻
zkuiav	自
zkuv	笫
zkuvu	秭
zkuvua	笫 秭
zkv	梓
zkva	辎
zkvaaa	辎
zkvi	髭
zkvia	鄑
zkviai	鄑
zkvii	鼒
zkviia	鼒
zkviiv	髭
zkvo	趑
zkvoov	趑
zkvovo	梓
zkvv	耔
zkvvai	耔
zl	做
zla	阼
zlaiuv	阼
zli	作
zlia	岞
zliauv	岞
zlii	坐
zliivo	坐
zliu	挫
zliuii	挫
zliuo	撮
zliuoi	撮
zliuoo	做
zliuov	捽
zliuvi	作
zliv	佐
zlivuv	佐
zlo	座
zloa	祚
zloauv	祚
zloi	昨
zloii	唑
zloiiv	唑
zloiuv	昨
zloo	嘬
zlooiv	嘬
zloou	怍
zloouv	怍
zlovii	座
zlu	胙
zluuvi	胙
zluv	笮
zluvuv	笮
zlv	左
zlvi	酢
zlviuv	酢
zlvu	柞
zlvuvi	左 柞
zlvv	琢
zlvvvu	琢
zn	怎
zno	谮
znoava	谮
znuvoa	怎
zp	藏
zpa	赃
zpaa	驵
zpaaia	驵
zpai	奘
zpaio	牂
zpaiou	牂
zpaivu	奘
zpaoov	赃
zpi	葬
zpiivu	藏 葬
zpu	脏
zpuovu	脏
zpv	臧
zpvuvi	臧
zr	增
zra	赠
zraa	缯
zraao	综
zraaoo	综
zraaou	缯
zraoou	赠
zri	锃
zria	罾
zriaou	罾
zrioov	锃
zro	曾
zroo	憎
zrooou	憎
zrou	甑
zroua	鄫
zrouai	鄫
zrouao	䎖
zrouoi	曾
zrouva	甑
zru	矰
zruvou	矰
zrvoou	增
zs	咋
zsi	扎
zsiu	拶
zsiuaa	扎 拶
zso	咱
zsouia	咱
zsouvi	咋
zsov	咂
zsovia	咂
zsu	杂
zsuavv	杂
zsuu	臜
zsuuvi	臜
zsv	砸
zsvi	匝
zsviai	匝
zsvuvi	砸
zta	赚
ztaa	缵
ztaauv	缵
ztaoou	赚
zti	钻
ztioiv	钻
ztiu	攥
ztiuuv	攥
zto	躜
ztoiuv	躜
ztu	纂
ztuvaa	纂
zw	贼
zwaovv	贼
zwi	撙
zwia	嶟
zwiaou	嶟
zwio	僔
zwioo	𨱔
zwioou	𨱔
zwiouv	僔
zwiuou	撙
zwo	尊
zwoi	蹲
zwoiou	蹲
zwoo	噂
zwoouv	噂
zwou	遵
zwouoa	遵
zwouvi	尊
zwu	鳟
zwua	鲗
zwuaao	鲗
zwuaou	鳟
zwv	樽
zwvouv	樽
zy	总
zya	纵
zyaa	综
zyaaii	纵
zyaaoo	综
zyi	偬
zyio	倧
zyiooa	倧
zyiuau	偬
zyo	宗
zyoi	踪
zyoioo	踪
zyoovv	宗
zyou	粽
zyouoa	总
zyouoo	粽
zyov	疭
zyovii	疭
zyu	腙
zyuooa	腙
zyv	棕
zyvi	鬃
zyvii	枞
zyviii	枞
zyvioo	鬃
zyvo	鬷
zyvooa	棕
zyvouo	鬷
zz	早
zza	澡
zzao	蚤
zzaoia	蚤
zzaooo	澡
zzi	藻
zzii	凿
zziiao	藻
zziiou	凿
zzo	糟
zzoi	躁
zzoioo	躁
zzoiuo	早
zzoo	噪
zzoooo	噪
zzoou	慥
zzoouv	慥
zzou	灶
zzoui	唣
zzouia	唣
zzouo	燥
zzouoo	燥
zzouvi	糟
zzouvo	灶
zzu	造
zzui	皂
zzuiva	皂
zzuv	簉
zzuvoa	造
zzuvuv	簉
zzv	遭
zzvi	枣
zzvioa	遭
zzvioo	枣
zzvu	𥖨
zzvuoo	𥖨
zzvv	璪
zzvvoo	璪